consent	同意	[kənˈsent]
confront	面对	[kənˈfrʌnt]
contestant	竞争者	[kənˈtestənt]
intent	意图	[ɪnˈtent]
instant	立刻	[ˈɪnstənt]
lewd	下流的	[lu:d]
profane	亵渎的	[prəˈfeɪn]
felony	重罪	[ˈfeləni]
convicted	已判刑的	[kən'vɪktɪd]
plantation	种植园	[plɑ:nˈteɪʃn]
transplant	移植	 [trænsˈplɑ:nt] 
authority	权威	[ɔ:ˈθɒrəti] 
term	学期	 [tɜ:m] 
theorize	创建理论	[ˈθɪəraɪz]
theorist	理论家	 [ˈθɪərɪst] 
fossilize	变成化石	 [ˈfɒsəlaɪz] 
fossil	化石	 [ˈfɒsl] 
religion	宗教	 [rɪˈlɪdʒən] 
region	地区	 [ˈri:dʒən] 
reproductive	生殖的	[ˌri:prəˈdʌktɪv] 
microorganism	微生物	[ˌmaɪkrəʊ'ɔ:gənɪzəm]
organism	生物体	 [ˈɔ:gənɪzəm] 
emotional	令人动情的	[ɪˈməʊʃənl]
mass	大量	 [mæs] 
periodic	周期的	[ˌpɪəriˈɒdɪk] 
environmentalist	环保人士	 [ɪnˌvaɪrənˈmentəlɪst]
hand over	交出	
retrieve	取回	[rɪˈtri:v] 
stack	堆	[stæk]
flip	轻击	[flɪp]
retract	缩回	[rɪˈtrækt
infant	婴儿	[ˈɪnfənt]
escalator	自动扶梯	 [ˈeskəleɪtə(r)]
handrail	扶手	[ˈhændreɪl] 
violator	违犯者	['vaɪəleɪtə(r)]
fresco	壁画	 [ˈfreskəʊ]
sculpture	雕塑	[ˈskʌlptʃə(r)]
chitchat	闲谈	 ['tʃɪttʃæt]
dozen	一打	 [ˈdʌzn]
doze	打盹儿	 [dəʊz]
grip	紧握	[grɪp]
lean	倾斜	 [li:n]
stow	装载	[stəʊ]
yawn	打呵欠	[jɔ:n]
aisle	过道	 [aɪl]
issue	问题，发行	['ɪsjuː] 
refund	偿还	 [ˈri:fʌnd]
depart	离开	[dɪˈpɑ:t]
resume	重新开始	 [rɪ'zju:m]
crew	工作人员	 [kru:]
freight	货物	[freɪt]
trolley	手推车	 [ˈtrɒli] 
converse	相反的，交谈	[kənˈvɜ:s]
escort	护送	[ˈeskɔ:t] 
interfere	妨碍	[ˌɪntəˈfɪə(r)] 
berth	卧铺	 [bɜ:θ] 
luggage	行李	 [ˈlʌgɪdʒ] 
pole	杆	[pəʊl]
harass	骚扰	[ˈhærəs]
hop	单足蹦跳	[hɒp]
rip	撕	 [rɪp]
rear	饲养，后面的，直立	[rɪə(r)]
chassis	（车辆的）底盘	[ˈʃæsi]
cabin	住在小屋里	[ˈkæbɪn]
conductor	售票员	 [kənˈdʌktə(r)]
fare	票价	 [feə(r)] 
inspect	检查	[ɪnˈspekt]
diesel	柴油机  	[ˈdi:zl] 
portable	轻便的	 [ˈpɔ:təbl]
greet	打招呼	[gri:t] 
hail	冰雹,打招呼	[heɪl]
tile	瓦片，瓷砖	[taɪl]
shuttle	梭子	 [ˈʃʌtl]
terminal	末端的	[ˈtɜ:mɪnl] 
metro	大都市的	 [ˈmetrəʊ] 
affix	粘贴	[əˈfɪks] 
frisk	搜（某人）的身	 [frɪsk] 
baggage	行李	[ˈbægɪdʒ]
convey	传递	[kənˈveɪ]
custom	习惯，海关	 [ˈkʌstəm] 
quarantine	对…进行检疫	 [ˈkwɒrənti:n] 
fasten	系牢	 [ˈfɑ:sn] 
highjack	抢劫	['haɪdʒæk]
recline	倚靠	 [rɪˈklaɪn]
lavatory	厕所	 [ˈlævətri] 
footrest	脚凳	 [ˈfʊtrest] 
copilot	飞机副驾驶员	 ['kəʊˌpaɪlət] 
airsick	晕机的	 [ˈeəsɪk] 
earplug	耳塞	 [ˈɪəplʌg] 
vest	马甲;防护衣；授权	[vest]
accommodate	容纳	 [əˈkɒmədeɪt]
disembark	上岸	 [ˌdɪsɪmˈbɑ:k]
refuel	（给）加油	[ˌri:ˈfju:əl] 
repair	修理	[rɪˈpeə(r)]
tow	拖	[təʊ] 
satellite	卫星	[ˈsætəlaɪt]
pedestrian	步行者	[pəˈdestriən] 
aviator	飞行员	[ˈeɪvieɪtə(r)] 
cargo	货物	[ˈkɑ:gəʊ]
coordinate	<数>坐标，协调	[kəʊ'ɔ:dɪneɪt] 
stroll	散步	[strəʊl] 
brochure	小册子	[ˈbrəʊʃə(r)] 
souvenir	纪念品   	[ˌsu:vəˈnɪə(r)]  
booklet	小册子	[ˈbʊklət]
consult	咨询	 [kənˈsʌlt] 
interpreter	口译译员	[ɪnˈtɜ:prɪtə(r)] 
narrator	解说员	[nəˈreɪtə(r)] 
bulletin	公告	 [ˈbʊlətɪn] 
discharge	卸货	[dɪsˈtʃɑ:dʒ]
dock	码头	 [dɒk] 
crane	吊车	[kreɪn]
trailer	拖车	[ˈtreɪlə(r)]
warehouse	仓库	 [ˈweəhaʊs]
shore	岸	 [ʃɔ:(r)]
tackle	用具	[ˈtækl]
tide	潮汐	 [taid]
bask	晒太阳	 [bɑ:sk] 
gamble	赌博	 [ˈgæmbl] 
jog	慢跑	 [dʒɒg] 
banquet	筵席	[ˈbæŋkwɪt]
casino	赌场	 [kəˈsi:nəʊ] 
deck	甲板	 [dek] 
cuisine	菜肴	[kwɪˈzi:n]
cast	投掷	[kɑ:st]
mariner	水手	[ˈmærɪnə(r)] 
binocular	双目望远镜	[bɪˈnɒkjələ(r)]
compass	罗盘	[ˈkʌmpəs]
chest	箱子，胸部	[tʃest] 
pave	铺路	[peɪv] 
hitch	钩住	[hɪtʃ] 
wary	谨慎的	[ˈweəri] 
excavate	挖掘	[ˈekskəveɪt] 
honk	汽车的喇叭声	[hɒŋk] 
pedal	踏板	[ˈpedl] 
condition	状态	 [kənˈdɪʃn] 
recondition	修复	 [ˌri:kənˈdɪʃn] 
helmet	头盔	[ˈhelmɪt] 
scooter	小型摩托车	 [ˈsku:tə(r)] 
saddle	马鞍	[ˈsædl] 
cyclist	骑自行车的人	[ˈsaɪklɪst]
gutter	排水沟	[ˈgʌtə(r)]
pot	罐	[pɒt]
sewer	下水道	[ˈsu:ə(r)]
jolt	使颠簸	 [dʒəʊlt]
bell	铃声	 [bel] 
brake	刹车	[breɪk] 
cage	笼子	[keɪdʒ] 
mud	泥	[mʌd] 
odometer	里程计	[əʊˈdɒmɪtə(r)]
fidget	坐立不安	[ˈfɪdʒɪt]
litter	垃圾	 [ˈlɪtə(r)] 
reverse	反转，倒退	 [rɪˈvɜ:s] 
snore	打呼噜	[snɔ:(r)] 
squash	挤进	 [skwɒʃ] 
buckle	扣环	[ˈbʌkl] 
horn	喇叭	 [hɔ:n] 
transmission	传动装置	[trænsˈmɪʃn]
chauffeur	为别人当汽车司机	 [ˈʃəʊfə(r)]
glove	手套	[glʌv]
dash	猛冲，破折号	 [dæʃ] 
gridlock	交通全面大堵塞	[ˈgrɪdlɒk] 
jaywalk	擅自穿越马路	[ˈdʒeɪwɔ:k]
junction	接合点	[ˈdʒʌŋkʃn] 
patrol	巡逻	[pəˈtrəʊl] 
retreat	撤退	[rɪˈtri:t] 
withdraw	撤退	[wɪðˈdrɔ:]
inject	注射	 [ɪnˈdʒekt]
transmit	传输	[trænsˈmɪt]
infrastructure	基础设施	[ˈɪnfrəstrʌktʃə(r)]
debate	辩论	[dɪˈbeɪt] 
broker	代理人	 [ˈbrəʊkə(r)]
distinct	有区别的；明显的	[dɪˈstɪŋkt]
inverse	相反的	 [ˌɪnˈvɜ:s] 
subscribe	签署	 [səbˈskraɪb] 
mechanism	机制	[ˈmekənɪzəm]
abnormal	反常的	 [æbˈnɔ:ml] 
standalone	独立的	 ['stændəˌləʊn] 
vender/vendor	售卖者	['vendə] 
consist	由…组成	 [kənˈsɪst]
burden	负担	 [ˈbɜ:dn]
conservative 	保守的人	[kənˈsɜ:vətɪv] 
conserve	保护	 [kənˈsɜ:v]
preserve	保护	[prɪˈzɜ:v]
assume	假定	[əˈsju:m]
collapse	崩溃	[kəˈlæps] 
construct	建造	 [kənˈstrʌkt] 
crumble	弄碎	[ˈkrʌmbl] 
erode	侵蚀	[ɪˈrəʊd]
rumble	隆隆声	[ˈrʌmbl] 
toll	通行费	[təʊl]
abutment	桥礅	 [ə'bʌtmənt] 
brick	砖	[brɪk] 
cement	水泥	 [sɪˈment] 
concrete	混凝土	 [ˈkɒŋkri:t] 
barrier	栅栏	[ˈbæriə(r)]
beam	梁	 [bi:m] 
culvert	涵洞	 [ˈkʌlvət] 
log	日志，伐木	 [lɒg]
steel	钢	 [sti:l] 
booth	隔开的小间	 [bu:ð] 
vagabond	流浪者	 [ˈvægəbɒnd] 
excavator	挖掘机	[ˈekskəveɪtə(r)] 
trunk	树干	[trʌŋk]
truck	货车	 [trʌk] 
hawk	鹰，叫卖	 [hɔ:k] 
aqueduct	沟渠	 [ˈækwɪdʌkt] 
lane	车道	 [leɪn]
graffiti	涂鸦	[grəˈfi:ti] 
rubber	橡胶，避孕套	 [ˈrʌbə(r)] 
wander	（道路或河流）蜿蜒曲折；漫步	 [ˈwɒndə(r)] 
tactile	触觉的	 [ˈtæktaɪl] 
shelter	避难所	[ˈʃeltə(r)]
con	反对票	 [kɒn] 
tramp	流浪汉	[træmp]
tarpaulin	防水帆布	[tɑ:ˈpɔ:lɪn]
clog	堵塞	 [klɒg] 
peddle	叫卖	[ˈpedl]
illuminate	照亮	[ɪˈlu:mɪneɪt] 
fortune	幸运	[ˈfɔ:tʃu:n]
palm	手掌	[pɑ:m]
peddler	毒贩	[ˈpedlə(r)] 
vagrant	流浪者	[ˈveɪgrənt] 
cock	公鸡	[kɒk] 
roach	蟑螂	 [rəʊtʃ] 
dust	灰尘	[dʌst]
bin	容器	[bɪn]
rat	老鼠	 [ræt]
barricade	路障	[ˌbærɪˈkeɪd] 
hitchhiker	搭便车的人	 [ˈhɪtʃhaɪk] 
gobble	狼吞虎咽地吃	[ˈgɒbl] 
nursery	婴儿室	[ˈnɜ:səri]
troop	一群	[tru:p]
trooper	伞兵，骑兵	 [ˈtru:pə(r)] 
janitor	看门人	 [ˈdʒænɪtə(r)] 
stallman	摊贩	 ['stɔ:lmən]
deli	熟食店	 [ˈdeli] 
beverage	饮料	[ˈbevərɪdʒ]
dismount	下车	[dɪsˈmaʊnt] 
trespass	非法侵入	 [ˈtrespəs] 
bump	 碰撞	[bʌmp]
bumper	保险杠	[ˈbʌmpə(r)] 
fender	挡泥板	[ˈfendə(r)] 
spare	备用的，节省	 [speə(r)] 
attendant	服务人员	[əˈtendənt] 
valet	侍者	[ˈvæleɪ]
trespasser	侵入者	[ˈtrespəsə(r)]
dispense	分配	 [dɪˈspens]
shrink	收缩	[ʃrɪŋk] 
inflate	膨胀	[ɪnˈfleɪt] 
pump	泵	 [pʌmp]
spill	溢出	[spɪl] 
tap	水龙头	 [tæp] 
hose	软管	 [həʊz]
nozzle	喷嘴	[ˈnɒzl]
sanitary	公共厕所，清洁的	 [ˈsænətri]
jockey	操作者;欺骗	 [ˈdʒɒki] 
mechanic	技工	 [məˈkænɪk] 
lubricant	润滑油	 [ˈlu:brɪkənt] 
couch	长沙发椅	[kaʊtʃ] 
stereo	立体声的	 [ˈsteriəʊ] 
carpet	地毯	 [ˈkɑ:pɪt] 
cushion	垫子	[ˈkʊʃn]
cabinet	柜橱	[ˈkæbɪnət] 
rug	小块地毯	 [rʌg] 
imitation	仿制品	 [ˌɪmɪˈteɪʃn] 
sitcom	情景喜剧	[ˈsɪtkɒm] 
antenna	天线	[ænˈtenə] 
commercial	商业的，广告	 [kəˈmɜ:ʃl] 
episode	一集	[ˈepɪsəʊd]
finale	结局	 [fɪˈnɑ:li] 
outlet	出口	 [ˈaʊtlet] 
premiere	首映	 [ˈpremieə(r)]
prime	首要的	 [praɪm]
subtitle	小标题，字幕	[ˈsʌbtaɪtl]
anchor	锚，在…任节目主持人	 [ˈæŋkə(r)]
squeeze	挤	[skwi:z] 
mug	马克杯	 [mʌg]
saucer	茶托	[ˈsɔ:sə(r)] 
steak	牛排	 [steɪk]
teapot	茶壶	 [ˈti:pɒt] 
coaster	杯托，雪橇	[ˈkəʊstə(r)]
pad	垫	 [pæd] 
kitchen	厨房	[ˈkɪtʃɪn] 
mat	垫子	 [mæt] 
tissue	薄纸，组织	[ˈtɪʃu:]
grate	磨碎	 [greɪt] 
ketchup	番茄酱	[ˈketʃəp]
mustard	芥末	 [ˈmʌstəd]
pepper	胡椒	[ˈpepə(r)] 
mill	研磨	[mɪl]
soy	酱油	 [sɔɪ]
sauce	调味汁	 [sɔ:s] 
Christian	基督教徒	 [ˈkrɪstʃən] 
blanch	漂白	[blɑ:ntʃ] 
roast	烤	[rəʊst]
saute	炒	[ˈsəʊteɪ]
simmer	炖	 [ˈsɪmə(r)] 
steam	蒸	[sti:m]
stew	炖	[stju:]
colander	漏勺	 [ˈkʌləndə(r)] 
cleaver	剁肉刀	 [ˈkli:və(r)] 
skillet	煎锅	 [ˈskɪlɪt] 
grater	刨丝器	 [ˈgreɪtə(r)] 
ladle	长柄勺	[ˈleɪdl] 
spatula	铲	 [ˈspætʃələ] 
wok	炒菜锅	[wɒk]
aluminum	铝	 [ə'lju:minəm] 
foil	箔	[fɔɪl]
apron	围裙	[ˈeɪprən] 
mitt	棒球手套	 [mɪt] 
blender	搅拌机	[ˈblendə(r)] 
extractor	抽油烟机	[ɪkˈstræktə(r)]
hood	头巾	 [hʊd] 
air conditioner	空调设备	 [eə(r) kənˈdiʃənə] 
frost	结霜	 [frɒst] 
mildew	霉	[ˈmɪldju:] 
rot	腐烂	[rɒt] 
spoil	变质	[spɔɪl]
sterilize	消毒	 [ˈsterəlaɪz] 
compartment	隔间	[kəmˈpɑ:tmənt]
thermostat	恒温（调节）器	[ˈθɜ:məstæt]
cube	立方体	 [kju:b] 
condenser	冷凝器	[kənˈdensə(r)]
magnet	磁铁	[ˈmægnət] 
insulation	绝缘	 [ˌɪnsjuˈleɪʃn] 
justice	正义	[ˈdʒʌstɪs]
constitution	宪法，组成	[ˌkɒnstɪˈtju:ʃn] 
democrat	民主党人	[ˈdeməkræt]
republican	共和主义的	[rɪˈpʌblɪkən]
sovereignty	主权国家	[ˈsɒvrənti]
territory 	领土	 [ˈterətri] 
claim 	提出要求	 [kleɪm] 
colonization	殖民	 [ˌkɒlənaɪ'zeɪʃn]
bilateral	双边的	 [ˌbaɪˈlætərəl] 
prosperity	繁荣	[prɒˈsperəti]
mutual	共同的	[ˈmju:tʃuəl] 
military 	军事的	[ˈmɪlətri]
counterpart	副本	[ˈkaʊntəpɑ:t] 
House of Lords	上议院	
The house of Commons	下议院	
lord	上帝	 [lɔ:d]
wield	支配	 [wi:ld] 
cyber	计算机（网络）的	 ['saɪbə] 
dynamic 	动态的	 [daɪˈnæmɪk] 
static	静止的	[ˈstætɪk] 
precise	精确的	[prɪˈsaɪs] 
era	时代	[ˈɪərə]
trend	趋势	[trend] 
tend	倾向，照料	[tend]
sphere	围绕，范围	[sfɪə(r)]
estimate	估计	[ˈestɪmət]
climate	气候	 [ˈklaɪmət] 
eliminate	淘汰	 [ɪˈlɪmɪneɪt] 
dominant	占优势的	[ˈdɒmɪnənt] 
selves	自我	 [selvz]
slap 	拍击	[slæp] 
despite	尽管	[dɪˈspaɪt]
gasp	喘气	 [gɑ:sp]
bargain 	交易	[ˈbɑ:gən]
rampage	暴怒	[ˈræmpeɪdʒ] 
impotent	虚弱的	 [ˈɪmpətənt] 
salient	突出的	 [ˈseɪliənt] 
devious	不正直的	[ˈdi:viəs] 
ultimate	极限的	 [ˈʌltɪmət] 
bearing	轴承	 [ˈbeərɪŋ] 
discriminate	辨别;歧视	 [dɪˈskrɪmɪneɪt]  
indiscriminate	不加选择的	[ˌɪndɪsˈkrɪmɪnət] 
impromptu	临时的	[ɪmˈprɒmptju:] 
acumen	敏锐	[ˈækjəmən] 
mandate	授权	[ˈmændeɪt]
sabotage	蓄意破坏	 [ˈsæbətɑ:ʒ]
tumble	使跌倒	[ˈtʌmbl] 
humility 	谦逊	 [hju:ˈmɪləti]
assiduous	刻苦的	 [əˈsɪdjuəs] 
uplift	举起，振作	 [ˈʌplɪft] 
dum(b)found	使惊得发呆	[ˌdʌm'faʊnd] 
inveterate	成瘾的	 [ɪnˈvetərət]
accountable	可解释的	[əˈkaʊntəbl] 
trudge	吃力地走	 [trʌdʒ]
incendiary	纵火的	 [ɪnˈsendiəri]
ascribe 	认为…是由于	 [əˈskraɪb]
protrude	使突出	[prəˈtru:d]
conscience	良心	 [ˈkɒnʃəns] 
incubate	孵化	[ˈɪŋkjubeɪt]
wreckage	残骸	[ˈrekɪdʒ] 
recoup	偿还	[rɪˈku:p] 
acclaim 	称赞	[əˈkleɪm]
evoke	唤起	[ɪˈvəʊk] 
exemplify 	举例证明	 [ɪgˈzemplɪfaɪ] 
neurosis	神经衰弱症	 [njʊəˈrəʊsɪs]
fiddly	要求高精度的	[ˈfɪdli] 
acrimony	（言语、态度等的）尖刻	[ˈækrɪməni] 
adjudicate	判决	 [əˈdʒu:dɪkeɪt] 
flog	鞭打	 [flɒg] 
insular	孤立的	 [ˈɪnsjələ(r)] 
furtive 	鬼鬼祟祟的	 [ˈfɜ:tɪv] 
entwine	缠绕	 [ɪnˈtwaɪn] 
mediate	调停	 [ˈmi:dieɪt]
ease	减轻	[i:z] 
neurological	神经学的	 [ˌnjʊərəˈlɒdʒɪkl] 
auspicious	吉利的	[ɔ:ˈspɪʃəs] 
strangle	窒息而死	 [ˈstræŋgl] 
transmute	使变形，使变质	[trænzˈmju:t] 
withstand	承受	 [wɪðˈstænd]
incipient	开始的	 [ɪnˈsɪpiənt] 
traverse	横越	 [trəˈvɜ:s] 
henpecked	（男子）受妻子管制的	 [ˈhenpekt] 
inflict	承受	 [ɪnˈflɪkt]
complexion	气色	 [kəmˈplekʃn] 
deprecate	不赞成	 [ˈdeprəkeɪt]
naturalize	接收（外国人）入籍	[ˈnætʃrəlaɪz] 
muck	弄脏	 [mʌk] 
abreast	并排的	[əˈbrest]
prone 	有…倾向的	 [prəʊn] 
parole	假释	[pəˈrəʊl]
rouse	使振奋	 [raʊz]
jest	开玩笑	 [dʒest] 
afflict 	折磨	[əˈflɪkt] 
jeopardize	危及	[ˈdʒepədaɪz]
daunt	使（某人）气馁	 [dɔ:nt] 
pant	喘气	 [pænt] 
victimize	使受骗	 [ˈvɪktɪmaɪz] 
connote	暗示	 [kəˈnəʊt]
curtail	削减	[kɜ:ˈteɪl]
brash	易碎的，碎片	 [bræʃ] 
periphery	边缘	 [pəˈrɪfəri] 
gentility	彬彬有礼	[dʒenˈtɪləti]
negate	否定	[nɪˈgeɪt]
intersperse 	点缀	 [ˌɪntəˈspɜ:s]
nostalgia	怀旧	[nɒˈstældʒə] 
scrawl	潦草地写	[skrɔ:l]
flounder	挣扎	 [ˈflaʊndə(r)] 
inexplicable 	无法解释的	[ˌɪnɪkˈsplɪkəbl]
emphasis	强调	 [ˈemfəsɪs] 
archaic	古色古香的	[ɑ:ˈkeɪɪk] 
genius	天才	 [ˈdʒi:niəs] 
genial 	和蔼的	[ˈdʒi:niəl] 
stereotype	陈规旧习	 [ˈsteriətaɪp]
aggravate	激怒	 [ˈægrəveɪt]
adamant	牢不可破的	 [ˈædəmənt] 
perfunctory	敷衍的	[pəˈfʌŋktəri]
partiality	偏袒	 [ˌpɑ:ʃiˈæləti] 
huddle	蜷缩	 [ˈhʌdl]
levity	欠考虑	 [ˈlevəti] 
ubiquitous	普遍存在的	 [ju:ˈbɪkwɪtəs] 
eligible	合适的	 [ˈelɪdʒəbl] 
decimate	大批杀害	[ˈdesɪmeɪt] 
outreach	拓广	 [ˈaʊtri:tʃ] 
legalize	使合法化	 [ˈli:gəlaɪz] 
heady	顽固的，（酒等）易使人醉的	 [ˈhedi]
fuzzy 	模糊的，毛茸茸的	 [ˈfʌzi] 
lament	哀悼	 [ləˈment] 
bulky	体积大的	 [ˈbʌlki]
baffle	挡板，使迷惑	 [ˈbæfl]
witch	女巫	女巫
bewitch	入迷	[bɪˈwɪtʃ]
inarticulate	不善辞令的	 [ˌɪnɑ:ˈtɪkjələt] 
nudge	轻推	 [nʌdʒ]
glaze	釉料，变得光滑	 [gleɪz] 
negotiable	可协商的	 [nɪˈgəʊʃiəbl] 
fervo(u)r	热情	[ˌfɜ:və] 
gratuitous	免费的	 [grəˈtju:ɪtəs] 
scupper	水性杨花的女人，水沟	 [ˈskʌpə(r)]
vogue	时髦的	 [vəʊg]
pervert	使堕落	 [pəˈvɜ:t]
estrange	使疏远	[ɪs'treɪndʒ]
abdicate 	放弃	 [ˈæbdɪkeɪt] 
sully	破坏名声	 [ˈsʌli] 
prod	刺激	 [prɒd] 
convoy	护送	 [ˈkɒnvɔɪ] 
hubbub	嘈杂的说话声	 [ˈhʌbʌb] 
persist 	继续存在	[pəˈsɪst]
boot	长靴	 [bu:t] 
bootleg	非法制造或贩卖	 [ˈbu:tleg] 
mimic	模仿	 [ˈmɪmɪk] 
exacerbate	使恶化	[ɪgˈzæsəbeɪt] 
dull	钝的	 [dʌl]
esoteric	秘传的	 [ˌesəˈterɪk]
babble	含糊不清的话	 [ˈbæbl] 
spar	试击	 [spɑ:(r)] 
grumpy	脾气暴躁的	 [ˈgrʌmpi]
secretive 	守口如瓶的	 [ˈsi:krətɪv] 
histrionic	做作的	 [ˌhɪstriˈɒnɪk] 
tilt	倾斜	 [tɪlt] 
eschew	回避	[ɪsˈtʃu:] 
gesticulate	做手势	 [dʒeˈstɪkjuleɪt]
juvenile 	少年的	[ˈdʒu:vənaɪl]
mirage	海市蜃楼	 [ˈmɪrɑ:ʒ] 
demean	使降低身份	[dɪˈmi:n]
wince	畏缩	[wɪns]
appraise 	估价	 [əˈpreɪz]
befit	适合于	[bɪˈfɪt] 
nonchalant	漠不关心的	 [ˈnɒnʃələnt] 
cryptic	有隐含意义的,神秘的	[ˈkrɪptɪk]
mitigate 	使减轻	[ˈmɪtɪgeɪt] 
torrid	炎热的	 [ˈtɒrɪd] 
impregnate	使饱和，使怀孕	 [ˈɪmpregneɪt] 
reparation 	修理	 [ˌrepəˈreɪʃn] 
mandatory	强制的	 [ˈmændətəri] 
evict	依法驱逐	 [ɪˈvɪkt] 
ostentatious	好夸耀的	 [ˌɒstenˈteɪʃəs] 
autograph	亲笔签名	 [ˈɔ:təgrɑ:f] 
satiate	充分满足，使厌腻	 [ˈseɪʃieɪt] 
understudy	替角	[ˈʌndəstʌdi] 
edgy	易激动的	 [ˈedʒi] 
suffice 	满足…的需要	 [səˈfaɪs] 
froth	口边白沫，无关紧要的小事	 [frɒθ]
woe	悲哀	 [wəʊ] 
harp	唠叨，弹竖琴	[hɑ:p]
conjure	施魔法	[ˈkʌndʒə(r)] 
infirm 	体弱的	 [ɪnˈfɜ:m]
fugitive	逃亡的	 [ˈfju:dʒətɪv] 
seminate	散布	 ['semɪneɪt] 
disseminate	散布	 [dɪˈsemɪneɪt] 
maniac	疯子	 [ˈmeɪniæk]
crave 	渴望	[kreɪv] 
speculate 	推测	 [ˈspekjuleɪt] 
lucrative	赚钱的	 [ˈlu:krətɪv]
airborne	空运的	 [ˈeəbɔ:n]
proportion 	比率	[prəˈpɔ:ʃn]
chivalry	骑士制度	 [ˈʃɪvəlri] 
conscript	被征入伍者	 [kənˈskrɪpt]
disposal 	处置	 [dɪˈspəʊzl] 
profess	宣称	 [prəˈfes]
impious	不虔诚的	 [ˈɪmpiəs] 
rinse	漂洗	 [rɪns] 
entrust	委托	 [ɪnˈtrʌst] 
hallucinate	使产生幻觉	 [həˈlu:sɪneɪt] 
amicable	友善的	 [ˈæmɪkəbl] 
invidious	激起怨恨的	 [ɪnˈvɪdiəs]
candid	率直的	 [ˈkændɪd] 
avenge	为…复仇	 [əˈvendʒ]
vitalize	赋予生命	 ['vaɪtəlaɪz]
facile	轻率作出的	 [ˈfæsaɪl] 
quaint	离奇有趣的	[kweɪnt]
despoil	掠夺	 [dɪˈspɔɪl] 
maim	使残废	 [meɪm]
penalize	对…予以惩罚	 [ˈpi:nəlaɪz] 
imperil	使陷于危险	 [ɪmˈperəl]
solace	安慰	[ˈsɒləs]
trundle	滚动	 [ˈtrʌndl] 
extrapolate	推断	[ɪkˈstræpəleɪt]
electrocute	触电致死	 [ɪˈlektrəkju:t] 
interminable	冗长的	 [ɪnˈtɜ:mɪnəbl]
mastermind	策划者	 [ˈmɑ:stəmaɪnd] 
thereto	此外	[ˌðeəˈtu:]
cyclic(al)	周期的	 [ˈsaɪklɪk] 
notoriety	臭名昭著	 [ˌnəʊtəˈraɪəti]
abound	非常多	 [əˈbaʊnd] 
permeate	渗透	 [ˈpɜ:mieɪt] 
haphazard	偶然的	 [hæpˈhæzəd] 
rejuvenate	变年轻	 [rɪˈdʒu:vəneɪt] 
diverge	分歧	 [daɪˈvɜ:dʒ]
flunk	不及格	 [flʌŋk] 
impede	阻碍	[ɪmˈpi:d]
horrid	恐怖的	 [ˈhɒrɪd] 
usurp	篡夺	 [ju:ˈzɜ:p]
veer	使改变方向	 [vɪə(r)] 
redolent	有强烈气味的;使人联想或回想起某事物的	 [ˈredələnt] 
obscenity	淫秽	 [əbˈsenəti] 
filial	子女的	 [ˈfɪliəl]
exonerate	免罪	[ɪgˈzɒnəreɪt] 
straggle	落后	 [ˈstrægl] 
lethal	致命的	 [ˈli:θl] 
intoxicate	使陶醉	[ɪn'tɒksɪkeɪt] 
antagonize	对…起反作用，中和	[ænˈtægənaɪz] 
ominous	不祥的	 [ˈɒmɪnəs]
pace	一步，怀着对…的敬意	 [peɪs] 
crunch	嘎吱嘎吱地咀嚼	[krʌntʃ]
adverse	相反的，不利的	 [ˈædvɜ:s]
conversant	熟悉的	[kənˈvɜ:snt]
wilt	枯萎	 [wɪlt] 
sympathy	同情	[ˈsɪmpəθi] 
pathologic(al)	病理的	 [ˌpæθə'lɒdʒɪk] 
flavor	给…调味	 ['fleɪvə] 
cardinal	基本的，大红色，红衣主教	[ˈkɑ:dɪnl]
juxtapose	把…并列	[ˌdʒʌkstəˈpəʊz] 
heretofore	在此以前	[ˌhɪətuˈfɔ:(r)] 
relapse	复发	 [rɪˈlæps] 
obsolete	废弃的	[ˈɒbsəli:t]
relent	动怜悯心	 [rɪˈlent] 
amalgamate	混合	 [əˈmælgəmeɪt] 
disjointed	不连贯的	 [dɪsˈdʒɔɪntɪd] 
crooked	弯曲的，不正当的	[ˈkrʊkɪd] 
dexterity	聪敏	[dekˈsterəti] 
imbue	使感染	 [ɪmˈbju:]
overt	公开的	[əʊˈvɜ:t] 
dither	颤抖	[ˈdɪðə(r)] 
spire	塔尖	[ˈspaɪə(r)]
transpire	使蒸发，使排出	[trænˈspaɪə(r)] 
introspection	反省	 [ˌɪntrəˈspekʃn] 
downstream	在下游方向的	[ˌdaʊnˈstri:m] 
pamper	娇惯	 [ˈpæmpə(r)] 
brevity	简洁	 [ˈbrevəti] 
incapacitate	使不适合	 [ˌɪnkəˈpæsɪteɪt]
accrue	积累	 [əˈkru:] 
glum	闷闷不乐的	[glʌm] 
irritant	有刺激性的，使无效的	 [ˈɪrɪtənt] 
animosity	憎恨	 [ˌænɪˈmɒsəti] 
perpetrate	犯（罪）	[ˈpɜ:pətreɪt]
falsity	虚假	 [ˈfɔ:lsəti] 
blemish	瑕疵	 [ˈblemɪʃ] 
surcharge	超载，附加费	 [ˈsɜ:tʃɑ:dʒ]
smear	弄脏	[smɪə(r)] 
juggle	玩杂耍，欺骗	 [ˈdʒʌgl] 
monumental	不朽的	 [ˌmɒnjuˈmentl] 
immaterial	非物质的	[ˌɪməˈtɪəriəl] 
enliven	使生动	 [ɪnˈlaɪvn] 
flimsy	薄弱的	 [ˈflɪmzi] 
phenomenal	显著的	[fəˈnɒmɪnl] 
surgent	汹涌的	['sɜ:dʒənt] 
insurgent	叛乱的	 [ɪnˈsɜ:dʒənt] 
falsify	弄虚作假	 [ˈfɔ:lsɪfaɪ] 
galvanize	激励	 [ˈgælvənaɪz] 
remunerate	酬劳	 [rɪˈmju:nəreɪt] 
adept	擅长于…的	[əˈdept] 
congenital	天生的	[kənˈdʒenɪtl] 
meditate	沉思	[ˈmedɪteɪt]
nautical	海上的	 [ˈnɔ:tɪkl] 
beguile	使陶醉	 [bɪˈgaɪl] 
stuffy	古板的	 [ˈstʌfi]
impetuous	冲动的	 [ɪmˈpetʃuəs]
squall	高声喊叫	 [skwɔ:l] 
reimburse	偿还	 [ˌri:ɪmˈbɜ:s] 
embody	使具体化	 [ɪmˈbɒdi] 
precipitate	使沉淀	 [prɪˈsɪpɪteɪt] 
fray	磨破	 [freɪ] 
demoralize	使士气低落	[dɪˈmɒrəlaɪz]
addictive	上瘾的	 [əˈdɪktɪv] 
apprehend	理解，逮捕	[ˌæprɪˈhend]
oncoming	即将到来的	 [ˈɒnkʌmɪŋ] 
prowess	英勇	 [ˈpraʊəs] 
uncharitable	不仁慈的	[ʌnˈtʃærɪtəbl] 
vindicate	证明…无辜	[ˈvɪndɪkeɪt] 
compulsion	强迫	[kəmˈpʌlʃn] 
devoid	没有	[dɪˈvɔɪd] 
posture	做出某种姿势	 [ˈpɒstʃə(r)] 
purge	净化	 [pɜ:dʒ] 
redemption	偿还	 [rɪˈdempʃn] 
vet	当兽医，检查	 [vet] 
instigate	煽动	[ˈɪnstɪgeɪt]
horseplay	动手脚和大声欢笑的玩闹	 [ˈhɔ:spleɪ] 
boggle	犹豫	 [ˈbɒgl] 
vengeful	渴望复仇的	[ˈvendʒfl] 
humdrum	乏味的	 [ˈhʌmdrʌm] 
manifestation	显示	 [ˌmænɪfeˈsteɪʃn]
pacify	抚慰	 [ˈpæsɪfaɪ] 
exude	使渗出	 [ɪgˈzju:d] 
verbatim	逐字翻译	 [vɜ:ˈbeɪtɪm] 
waver	摇摆	 [ˈweɪvə(r)] 
deluge	使泛滥	[ˈdelju:dʒ]
concede	让步	[kənˈsi:d] 
cuddle	拥抱	 [ˈkʌdl] 
threadbare	陈旧的	[ˈθredbeə(r)] 
snigger	窃笑	 [ˈsnɪgə(r)] 
impassioned	慷慨激昂	 [ɪmˈpæʃnd] 
pale	苍白的，栅栏	 [peɪl] 
hale	老当益壮的	 [heɪl] 
sophisticate	老于世故的人	[səˈfɪstɪkeɪt] 
vanquish	克服	[ˈvæŋkwɪʃ] 
incisive	直接的	 [ɪnˈsaɪsɪv]
outlandish	奇异的	 [aʊtˈlændɪʃ]
fabricate	捏造，装配	[ˈfæbrɪkeɪt]
blunder	（因无知、粗心等造成）的错误	 [ˈblʌndə(r)] 
meticulous	谨小慎微的	 [məˈtɪkjələs] 
malign	说坏话	 [məˈlaɪn] 
salvage	（从火灾、海难等中）抢救（某物）	 [ˈsælvɪdʒ] 
rattle	嘎嘎声	[ˈrætl]
lop	砍伐	[lɒp] 
discernible	可识别的	[dɪ'sɜ:nəbəl] 
radiant	容光焕发的	[ˈreɪdiənt] 
nab	逮住	 [næb] 
ingratiate	讨好	 [ɪnˈgreɪʃieɪt] 
robust	精力充沛的	 [rəʊˈbʌst]
tyrannize	横行霸道	 [ˈtɪrənaɪz] 
quiver	抖动	 [ˈkwɪvə(r)]
mundane	寻常的	 [mʌnˈdeɪn] 
enumerate	枚举	[ɪˈnju:məreɪt] 
epitome	（书、演讲等的）摘要	 [ɪˈpɪtəmi] 
writhe	（因极度痛苦而）扭动或翻滚	[raɪð] 
concord	一致，和谐	 [ˈkɒŋkɔ:d] 
hoax	骗局	 [həʊks]
dank	阴湿的	 [dæŋk] 
fraught	满载的	 [frɔ:t]
ferocity	暴行	[fəˈrɒsəti]
sniffle	抽鼻子	 [ˈsnɪfl] 
overlook	瞭望	 [ˌəʊvəˈlʊk] 
prodigy	天才	 [ˈprɒdədʒi] 
boost	提高	 [bu:st] 
intimidate	威胁	[ɪnˈtɪmɪdeɪt]
enthrone	使（国王、女王或主教）登基	 [ɪnˈθrəʊn] 
vex	使生气，详细讨论	 [veks] 
intimacy	亲昵的言行	 [ˈɪntɪməsi] 
daft	愚笨的	 [dɑ:ft] 
indigenous	土生土长的	 [ɪnˈdɪdʒənəs] 
inflammable	易燃的	 [ɪnˈflæməbl] 
culminate	达到极点	[ˈkʌlmɪneɪt]
coherent	一致的	 [kəʊˈhɪərənt] 
flawless	无瑕的	[ˈflɔ:ləs]
vice	副的，瑕疵	 [vaɪs] 
dote	溺爱	 [dəʊt]
deplete	用尽	 [dɪˈpli:t] 
octopus	八爪鱼	 [ˈɒktəpəs] 
opulent	富裕的	 [ˈɒpjələnt]
resort	求助	 [rɪˈzɔ:t] 
grovel	卑躬屈节	[ˈgrɒvl] 
hash	切碎	 [hæʃ] 
detonate	爆炸	 [ˈdetəneɪt] 
vile	卑鄙的	 [vaɪl] 
impoverish	使贫穷	 [ɪmˈpɒvərɪʃ] 
utmost	极度的	 [ˈʌtməʊst] 
strenuous	奋发的	 [ˈstrenjuəs] 
clutter	杂乱	 [ˈklʌtə(r)] 
categorical	分类的，绝对的	[ˌkætəˈgɒrɪkl] 
forge	伪造，锻造	 [fɔ:dʒ] 
sanctify	认可	[ˈsæŋktɪfaɪ] 
interject	插话	 [ˌɪntəˈdʒekt] 
rabid	狂暴的	 [ˈræbɪd] 
itinerant	巡回的	 [aɪˈtɪnərənt] 
hyperactive	极度活跃的	 [ˌhaɪpərˈæktɪv] 
forestall	垄断	 [fɔ:ˈstɔ:l] 
shunt	转向一边	 [ʃʌnt] 
intractable	难对付的	[ɪnˈtræktəbl]
fictitious	虚构的	 [fɪkˈtɪʃəs] 
spatter	溅	 [ˈspætə(r)] 
flurry	使慌张	[ˈflʌri] 
pester	使为难	[ˈpestə(r)]
ensconce	使安顿	[ɪnˈskɒns]
prominence	卓越	[ˈprɒmɪnəns]
disavow	抵赖	 [ˌdɪsəˈvaʊ] 
encumber	阻碍	 [ɪnˈkʌmbə(r)] 
grisly	可怕的	 [ˈgrɪzli] 
brusque	莽撞的	 [bru:sk] 
orthodoxy	正统	 [ˈɔ:θədɒksi] 
emend	校订	 [iˈmend]
inoculate	给…做预防注射	 [ɪˈnɒkjuleɪt] 
flirt	打情骂俏	 [flɜ:t]
gravitate	被吸引，受重力作用	[ˈgrævɪteɪt] 
disentangle	解开…的结	 [ˌdɪsɪnˈtæŋgl] 
solvent	可溶解的	 [ˈsɒlvənt] 
snipe	狙击	[snaɪp] 
invoice	开发票	[ˈɪnvɔɪs] 
uncouth	不文明的	 [ʌnˈku:θ] 
gallantry	（对女子的）殷勤	[ˈgæləntri]
nomadic	游牧的	 [nəʊ'mædɪk] 
desiccate	使脱水	 ['desɪˌkeɪt] 
augment	增强	[ɔ:gˈment] 
jeer	嘲讽	 [dʒɪə(r)]
grotesque	奇形怪状的	 [grəʊˈtesk] 
trepid	惊恐的	 ['trepɪd] 
intrepid	无畏的	[ɪnˈtrepɪd] 
gauge	评估	 [ɡeɪdʒ]
segregation	隔离	 [ˌsegrɪˈgeɪʃn] 
delve	挖掘	[delv]
astray	误入歧途的	[əˈstreɪ] 
motley	杂色的	 [ˈmɒtli] 
rut	车辙，惯例，发情期	 [rʌt]
equivocal	模棱两可的	[ɪˈkwɪvəkl] 
pin	针	 [pɪn] 
pinch	掐	 [pɪntʃ] 
savo(u)r	使有风味	['seɪvə] 
affection	喜爱，疾病	 [əˈfekʃn]
majestic	宏伟的	[məˈdʒestɪk] 
ascendant	占优势的	 [əˈsendənt] 
relegate	使降职，转移，把…归类	 [ˈrelɪgeɪt] 
jumble	杂乱	 [ˈdʒʌmbl]
susceptible	易受感染的	 [səˈseptəbl]
belie	证明…为虚假	 [bɪˈlaɪ] 
composite	混合成的	 [ˈkɒmpəzɪt] 
incarnate	拟人化的	 [ɪnˈkɑ:nət]
indoctrinate	向…灌输（信仰）	 [ɪnˈdɒktrɪneɪt] 
misgiving	疑虑	[ˌmɪsˈgɪvɪŋ] 
passive	被动的	 [ˈpæsɪv] 
impassive	冷漠的	 [ɪmˈpæsɪv]
calamity	不幸之事	 [kəˈlæməti] 
explicable	可解释的	 [ɪkˈsplɪkəbl] 
legislate	制定法律	 [ˈledʒɪsleɪt] 
docile	驯服的	 [ˈdəʊsaɪl] 
destitute	贫乏的	[ˈdestɪtju:t] 
feign	假装	 [feɪn] 
meander	（指溪流、河流等）蜿蜒而流，闲逛	 [miˈændə(r)] 
marginal	临界的	 [ˈmɑ:dʒɪnl] 
charitable	慈善的	[ˈtʃærətəbl] 
imprint	盖印	 [ɪmˈprɪnt] 
subside	减弱	[səbˈsaɪd] 
hamstring	腿筋	 [ˈhæmstrɪŋ] 
delible	可抹掉的	['deləbəl] 
indelible	不可磨灭的	 [ɪnˈdeləbl] 
terse	（说话、文笔等）精练的	 [tɜ:s]
denominate	称呼	 [dɪˈnɒmɪneɪt] 
discerning	有识别力的	 [dɪˈsɜ:nɪŋ] 
gossip	闲聊,谣言	 [ˈgɒsɪp] 
philanthropic	博爱的	[ˌfɪlən'θrɒpɪk] 
inordinate	过度的	 [ɪnˈɔ:dɪnət]
ethic	伦理	 [ˈeθɪk]
militant	好战的	 [ˈmɪlɪtənt] 
impel	推进或敦促某人做某事	 [ɪmˈpel] 
decorous	端庄得体的	 [ˈdekərəs]
captivity	囚禁	 [kæpˈtɪvəti] 
combustible	易燃的	 [kəmˈbʌstəbl] 
enchant	使迷惑	[ɪnˈtʃɑ:nt] 
disenchant	使清醒	[ˌdɪsɪn'tʃænt] 
cajole	以甜言蜜语哄骗	 [kəˈdʒəʊl] 
gruesome	可怕的	 [ˈgru:səm]
protocol	协议	[ˈprəʊtəkɒl]
override	覆盖	 [ˌəʊvəˈraɪd] 
reveal	揭露	 [rɪˈvi:l]
ravel	纠缠	 [ˈrævl] 
unravel	拆散	 [ʌnˈrævl]
nuance	细微差别	 [ˈnju:ɑ:ns] 
hurtle	猛冲	 [ˈhɜ:tl] 
delirious	极兴奋的	 [dɪˈlɪriəs] 
flabby	肌肉松垂的	 [ˈflæbi] 
gnarled	（手、手指）粗糙的	[nɑ:ld] 
callous	长茧的，铁石心肠的	[ˈkæləs] 
infringe	侵犯	 [ɪnˈfrɪndʒ] 
retard	减慢	 [rɪˈtɑ:d] 
paramount	最高	[ˈpærəmaʊnt] 
substantiate	证实	 [səbˈstænʃieɪt] 
ineffectual	无效的	 [ˌɪnɪˈfektʃuəl]
fastidious	挑剔的	 [fæˈstɪdiəs] 
scoff	嘲笑	[skɒf] 
nurture	培育	 [ˈnɜ:tʃə(r)]
decoy	诱捕	[ˈdi:kɔɪ]
twitch	抽筋，猛拉	 [twɪtʃ] 
momentous	关键的	 [məˈmentəs] 
underwrite	签名承认	[ˌʌndəˈraɪt]
transcribe	抄写	 [trænˈskraɪb] 
allure	诱惑	[əˈlʊə(r)] 
irretrievable	不能挽回的	 [ˌɪrɪˈtri:vəbl] 
inflow	流入	[ˈɪnfləʊ] 
vent	发泄	 [vent] 
rig	操纵，船桅（或船帆等）的装置，阴谋	 [rɪg]
shatter	碎片	 [ˈʃætə(r)] 
procure	拉皮条，取得	 [prəˈkjʊə(r)] 
procedural	程序的	 [prə'si:dʒərəl]
plead	为…辩护	 [pli:d] 
glimpse	一瞥	 [glɪmps] 
glee	快乐，重唱的歌曲	[gli:]
knead	揉	 [ni:d] 
squeal	发尖叫声，激烈抗议	[skwi:l] 
accede	加入，增加	 [əkˈsi:d] 
invoke	祈求，提出或授引…以支持或证明	 [ɪnˈvəʊk]
awkward	令人尴尬的	 [ˈɔ:kwəd] 
schema	计划	 [ˈski:mə]
schematize	将…列入计划	[ˈski:mətaɪz] 
shroud	覆盖	 [ʃraʊd] 
viable	切实可行的	 [ˈvaɪəbl] 
undue	过度的	[ˌʌnˈdju:] 
tatter	破布条	['tætə]
thump	重击	 [θʌmp] 
gallant	对妇女献殷勤的男人	 [ˈgælənt] 
ravish	使着迷	 [ˈrævɪʃ] 
slavish	奴隶似的	 [ˈsleɪvɪʃ] 
perk	振作，外快	 [pɜ:k] 
misconduct	处理…失当	 [ˌmɪsˈkɒndʌkt] 
slop	溢出	 [slɒp]
fallow	犁过而未播种的	 [ˈfæləʊ] 
cerebral	理智的	 [ˈserəbrəl] 
moisturize	使湿润	 [ˈmɔɪstʃəraɪz] 
inquire	询问	[ɪn'kwaɪə(r)]
provident	有远见的，节俭的	[ˈprɒvɪdənt] 
nub	要点;瘤	 [nʌb] 
snub	冷落	[snʌb] 
drench	弄湿	 [drentʃ] 
confide	吐露（秘密、心事等）	 [kənˈfaɪd] 
covert	隐蔽的	[ˈkʌvət] 
brunt	冲击	 [brʌnt] 
despicable	卑鄙的	 [dɪˈspɪkəbl] 
radiate	辐照	 [ˈreɪdieɪt]
irradiate	辐照	 [ɪˈreɪdieɪt] 
sporadic	时有时无的	 [spəˈrædɪk]
deplore	哀叹，谴责	 [dɪˈplɔ:(r)]
vicinity	附近	 [vəˈsɪnəti]
dwell	居住，细想某事	 [dwel] 
arbitrate	仲裁	[ˈɑ:bɪtreɪt]
dormant	潜伏的	 [ˈdɔ:mənt]
fiddling	微不足道的，篡改	 [ˈfɪdlɪŋ] 
fiddle	篡改；小提琴	[ˈfɪdl] 
harbinger	预兆	[ˈhɑ:bɪndʒə(r)] 
imperceptible	感觉不到的	 [ˌɪmpəˈseptəbl] 
mercantile	商业的	 [ˈmɜ:kəntaɪl] 
horrendous	可怕的	 [hɒˈrendəs] 
understate	保守地说	[ˌʌndəˈsteɪt] 
gape	张开，张口结舌地看	[geɪp] 
impound	将…关起来	[ɪmˈpaʊnd] 
expedite	加快进展	 [ˈekspədaɪt] 
insolent	侮慢的	 [ˈɪnsələnt] 
ephemeral	瞬息的	 [ɪˈfemərəl] 
beastly	野兽般的	 [ˈbi:stli] 
beast	野兽	[bi:st] 
possess	拥有	 [pəˈzes] 
humbug	欺骗	[ˈhʌmbʌg] 
hum	嗡嗡声;	 [hʌm] 
coop	笼子	 [ku:p] 
severity	严格	 [sɪ'verətɪ] 
graft	移植，贪污	 [grɑ:ft] 
warranty	保证	 [ˈwɒrənti]
skinny	皮的	[ˈskɪni] 
sleazy	低劣的	 [ˈsli:zi] 
indemnify	补偿	 [ɪnˈdemnɪfaɪ] 
dislocate	使关节脱位;使（交通，事务等）混乱	 [ˈdɪsləkeɪt] 
fracture	破裂	 [ˈfræktʃə(r)]
sober	头脑清醒的	 [ˈsəʊbə(r)] 
trounce	责骂	 [traʊns] 
subordinate	次要的	 [səˈbɔ:dɪnət] 
inborn	先天的	 [ˌɪnˈbɔ:n] 
repellent	防水的	 [rɪˈpelənt] 
abolish	废除	 [əˈbɒlɪʃ] 
assail	攻击	 [əˈseɪl] 
rove	漂泊	 [rəʊv]
leash	用皮带系住	 [li:ʃ] 
unleash	解除…的束缚	 [ʌnˈli:ʃ] 
unscrew	从…旋出螺丝	 [ˌʌnˈskru:] 
defile	峡谷，弄脏	 [dɪˈfaɪl] 
umpire	当裁判	 [ˈʌmpaɪə(r)]
ambivalent	矛盾的	 [æmˈbɪvələnt] 
grapple	扭打	 [ˈgræpl] 
emaciated	瘦弱的	[ɪˈmeɪʃieɪtɪd] 
impart	给予	 [ɪmˈpɑ:t] 
counterfeit	仿制品	 [ˈkaʊntəfɪt] 
vie	使竞争	[vaɪ] 
pernicious	致命的	 [pəˈnɪʃəs] 
hew	（用斧、刀等）砍	[hju:] 
encompass	包围	 [ɪnˈkʌmpəs] 
allude	暗指	[əˈlu:d]
clandestine	秘密的	 [klænˈdestɪn] 
destine	注定	 ['destɪn] 
clan	氏族	 [klæn] 
steep	陡峭的，使浸透	[sti:p] 
congenial	性格相似的	 [kənˈdʒi:niəl] 
goggle	瞪眼，护目镜	 [ˈgɒgl] 
fritter	浪费	 [ˈfrɪtə(r)] 
hobnob	（亲切）交谈	 [ˈhɒbnɒb] 
imbibe	吸收	 [ɪmˈbaɪb] 
tantalize	使干着急	 [ˈtæntəlaɪz] 
apposite	合适的	 [ˈæpəzɪt]
hinge	转折点	 [hɪndʒ]
badger	獾，烦扰	[ˈbædʒə(r)]
hypo	给…作皮下注射	 ['haɪpəʊ] 
hypocrisy	虚伪	 [hɪˈpɒkrəsi] 
controvertible	可争论的	 [ˌkɒntrə'vɜ:tɪbl] 
incontrovertible	不容置疑的	 [ˌɪnkɒntrəˈvɜ:təbl] 
inquisitive	好问的	 [ɪnˈkwɪzətɪv] 
reverence	尊敬	[ˈrevərəns]
prudent	谨慎的	[ˈpru:dnt]
imprudent	不谨慎的	 [ɪmˈpru:dnt] 
atrocious	穷凶极恶	 [əˈtrəʊʃəs]
nag	抱怨	 [næg] 
sue	起诉	 [su:]
revere	敬畏	 [rɪˈvɪə(r)] 
rake	耙，梳理	[reɪk] 
obese	极为肥胖的	 [əʊˈbi:s] 
maul	大木槌	 [mɔ:l] 
refurbish	刷新	 [ˌri:ˈfɜ:bɪʃ]
canvass	（在政治方面）游说	 [ˈkænvəs] 
patriotic	爱国的	 [ˌpeɪtriˈɒtɪk] 
patronage	赞助	[ˈpætrənɪdʒ]
aspire	渴望	 [əˈspaɪə(r)]
hereof	于此	 [ˌhɪərˈɒv] 
declaim	抨击	 [dɪˈkleɪm] 
nerve	鼓励，神经，勇气	
unnerve	使身心交疲	[ˌʌnˈnɜ:v] 
mediocre	中等的	[ˌmi:diˈəʊkə(r)] 
abase	贬低	 [əˈbeɪs] 
stint	定额	 [stɪnt] 
quash	废除，平息	 [kwɒʃ]
fortuitous	偶然发生的	 [fɔ:ˈtju:ɪtəs] 
idyllic	田园诗般的	 [ɪˈdɪlɪk] 
malignant	致命的	 [məˈlɪgnənt] 
intuitive	直观的	 [ɪnˈtju:ɪtɪv] 
previsional	有先见之明的	 [pri:'vɪʒənəl] 
provisional	临时的	[prəˈvɪʒənl] 
anesthetic	麻醉剂	 [ˌænəs'θetɪk]
pragmatic	实用主义的，好管闲事的	 [prægˈmætɪk] 
neurotic	神经病人	 [njʊəˈrɒtɪk] 
conceivable	可想像的	 [kənˈsi:vəbl] 
inconceivable	不可思议的	 [ˌɪnkənˈsi:vəbl] 
disclaim	否认	 [dɪsˈkleɪm] 
dole	失业救济金	 [dəʊl] 
preferential	优先的	 [ˌprefəˈrenʃl] 
circumstance	环境	 [ˈsɜ:kəmstəns] 
circumstantial	间接的 	 [ˌsɜ:kəmˈstænʃl] 
involuntary	非自愿的	 [ɪnˈvɒləntri] 
hefty	健壮的	 [ˈhefti] 
ornate	矫揉造作的	[ɔ:ˈneɪt] 
finicky	过分讲究的	 [ˈfɪnɪki] 
confer	授予，比较，磋商	 [kənˈfɜ:(r)] 
propagate	繁殖	 [ˈprɒpəgeɪt] 
funky	惊恐的，时髦的	 [fʌŋki]
fiendish	残酷的	 [ˈfi:ndɪʃ] 
pore	毛孔，钻研	 [pɔ:(r)] 
panoramic	全景的	[ˌpænə'ræmɪk]
zest	风味	 [zest] 
undulate	波动起伏的	 [ˈʌndjuleɪt] 
abduct	诱拐	 [æbˈdʌkt] 
multitude	大量	 [ˈmʌltɪtju:d] 
mope	忧郁地闲荡	 [məʊp] 
tentative	试验的	 [ˈtentətɪv] 
scrounge	乞讨	 [skraʊndʒ] 
wade	跋涉	 [weɪd]
lure	引诱	 [lʊə(r)] 
unilateral	单边的	 [ˌju:nɪˈlætrəl]
arduous	艰巨的	[ˈɑ:djuəs] 
miscarriage	流产	 [ˈmɪskærɪdʒ] 
flick	轻击	 [flɪk]
flicker	闪烁	 [ˈflɪkə(r)]
doom	厄运，宣判	[du:m]
haggle	讨价还价	 [ˈhægl] 
fumble	笨手笨脚地做	 [ˈfʌmbl] 
fetid	恶臭的	 [ˈfetɪd] 
persecute	烦扰	[ˈpɜ:sɪkju:t]
sprawl	蔓延	 [sprɔ:l] 
holocaust	大屠杀	 [ˈhɒləkɔ:st] 
zoom	使急速上升，隆隆声	 [zu:m] 
utter	发出声音，完全的	 [ˈʌtə(r)] 
assent	同意	 [əˈsent] 
audible	听得见的	 [ˈɔ:dəbl] 
ably	精明强干地	 [ˈeɪbli] 
warp	弄弯	 [wɔ:p] 
adulterate	掺假的，通奸的	 [əˈdʌltəreɪt] 
embezzle	贪污	 [ɪmˈbezl] 
evince	表明	 [ɪˈvɪns] 
mollify	抚慰	 [ˈmɒlɪfaɪ] 
bustle	喧闹，奔忙	 [ˈbʌsl]
bust	胸围，打破	 [bʌst] 
strut	炫耀	 [strʌt] 
intercession	调停	 [ˌɪntə'seʃn] 
compatible	兼容的	 [kəmˈpætəbl] 
seclude	使隔绝	 [sɪˈklu:d] 
roost	栖息，得到报应	 [ru:st]
pristine	纯朴的	 [ˈprɪsti:n] 
homogeneous	同类的	 [ˌhɒməˈdʒi:niəs] 
circumvent	避免	[ˌsɜ:kəmˈvent] 
elude	逃避	 [iˈlu:d] 
revert	恢复	 [rɪˈvɜ:t] 
counteract	抵消	 [ˌkaʊntərˈækt] 
dispose	处置，使倾向于	[dɪˈspəʊz] 
advent	到来	 [ˈædvent] 
tarnish	晦暗	 [ˈtɑ:nɪʃ] 
parody	拙劣的模仿	 [ˈpærədi] 
trait	特点	 [treɪt] 
infantile	婴儿（期）的，孩子气的	 [ˈɪnfəntaɪl] 
allergic	过敏的	 [əˈlɜ:dʒɪk] 
be allergic to	对。。。过敏	
anguish	使苦恼	 [ˈæŋgwɪʃ] 
hackneyed	使用过于频繁的，陈腐的	 [ˈhæknid] 
assimilate	吸收	 [əˈsɪməleɪt] 
languid	疲倦的	 [ˈlæŋgwɪd] 
unrelenting	不松懈的	 [ˌʌnrɪˈlentɪŋ] 
patronize	资助	[ˈpætrənaɪz] 
headstrong	任性的	 [ˈhedstrɒŋ] 
elicit	引出	 [iˈlɪsɪt] 
scowl	皱眉表示	 [skaʊl] 
squalid	污秽的	 [ˈskwɒlɪd] 
articulate	清晰地发（音）	 [ɑ:ˈtɪkjuleɪt] 
lurch	摇晃	 [lɜ:tʃ] 
oust	驱逐	 [aʊst]
wiggle	摆动	 [ˈwɪgl] 
succession	继承顺序	 [səkˈseʃn] 
fecund	肥沃的	 [ˈfi:kənd] 
conduct	执行	[kənˈdʌkt] 
miscellaneous	各种各样的	 [ˌmɪsəˈleɪniəs] 
plight	困境，誓约	 [plaɪt] 
herein	于此	 [ˌhɪərˈɪn]
punitive	处罚的	 [ˈpju:nətɪv] 
lime	石灰	 [laɪm] 
sublime	庄严的	[səˈblaɪm] 
subline	亚系	 ['sʌblaɪn] 
palpable	明显的	 [ˈpælpəbl] 
immerse	浸没	[ɪˈmɜ:s] 
feck	价值	 [fek]
feckless	没有价值的	 [ˈfekləs] 
ablaze	发光的	 [əˈbleɪz] 
composure	沉着	 [kəmˈpəʊʒə(r)] 
interlock	互锁	[ˌɪntəˈlɒk] 
extol	吹捧	 [ɪkˈstəʊl] 
outright	彻底的	 [ˈaʊtraɪt] 
grained	有木纹的	 [greɪnd] 
ingrained	根深蒂固的	 [ɪnˈgreɪnd] 
nebulous	模糊的	 [ˈnebjələs] 
abject	下贱的	[ˈæbdʒekt] 
quench	解（渴），（用水）扑灭（火焰等）	[kwentʃ] 
fraternal	兄弟般的	 [frəˈtɜ:nl] 
eject	喷出	 [iˈdʒekt] 
perpetuate	使永存	 [pəˈpetʃueɪt] 
perish	毁灭	 [ˈperɪʃ] 
irreversible	不可逆的	[ˌɪrɪˈvɜ:səbl]
squirm	蠕动	[skwɜ:m] 
collude	密谋	 [kəˈlu:d] 
comparison	对照	 [kəmˈpærɪsn]
remit	汇款，缓和	 [ˈri:mɪt]
pertinent	有关的	 [ˈpɜ:tɪnənt] 
throttle	喉咙，勒死	 [ˈθrɒtl] 
swipe	刷（磁卡）,重击	[swaɪp]
coy	腼腆的	 [kɔɪ] 
definitive	决定性的	 [dɪˈfɪnətɪv]
compromise	妥协	 [ˈkɒmprəmaɪz] 
compunction	后悔	 [kəmˈpʌŋkʃn] 
rogatory	查询的	 ['rɒgətɔ:rɪ] 
derogatory	贬低的	 [dɪˈrɒgətri] 
interplay	相互作用	 [ˈɪntəpleɪ] 
casual	随便的	 [ˈkæʒuəl] 
discount	折扣	 [ˈdɪskaʊnt] 
vista	展望，回顾	 [ˈvɪstə] 
regress	回归	 [rɪˈgres] 
repress	压抑	 [rɪˈpres] 
molest	（对女性）动手动脚	 [məˈlest] 
validate	使合法化	 [ˈvælɪdeɪt] 
totter	蹒跚	 [ˈtɒtə(r)] 
mountable	可安装的	 ['maʊntəbl] 
surmountable	可战胜的	[sɜ:'maʊntəbl]
insurmountable	不可逾越的	 [ˌɪnsəˈmaʊntəbl] 
luminous	发光的	 [ˈlu:mɪnəs]
vestige	退化的器官，残余部分	[ˈvestɪdʒ] 
extract	提取	 [ˈekstrækt] 
inhibit	禁止	 [ɪnˈhɪbɪt] 
evermore	永久	 [ˌevəˈmɔ:(r)] 
wedge	楔入	 [wedʒ] 
rack	支架，使痛苦	 [ræk] 
sprint	全速短跑	[sprɪnt] 
strew	撒在…上	 [stru:] 
impinge	对…有明显作用（或影响）	[ɪmˈpɪndʒ] 
loiter	闲逛	 [ˈlɔɪtə(r)]
benign	温和的	 [bɪˈnaɪn] 
jubilant	喜气洋洋的	 [ˈdʒu:bɪlənt] 
impetus	势头	 [ˈɪmpɪtəs] 
legendary	传说的	[ˈledʒəndri]
thereupon	随即	 [ˌðeərəˈpɒn] 
momentum	势头	 [məˈmentəm] 
menial	（指工作）卑贱的	 [ˈmi:niəl] 
respective	各自的	 [rɪˈspektɪv] 
irrespective	不考虑的	 [ˌɪrɪ'spektɪv] 
reshuffle	改组（尤指政治组织）	 [ˌri:ˈʃʌfl] 
bode	预示	 [bəʊd]
forebode	预示	 [fɔ:'bəʊd] 
fervent	炽热的	 [ˈfɜ:vənt] 
hereafter	从此以后	 [ˌhɪərˈɑ:ftə(r)]
impersonate	拟人	 [ɪmˈpɜ:səneɪt] 
entail	使必要	 [ɪnˈteɪl] 
presumption	推测，傲慢	[prɪˈzʌmpʃn] 
parry	避开	 [ˈpæri] 
negligent	粗心大意的	 [ˈneglɪdʒənt] 
poach	水煮，窃取	 [pəʊtʃ] 
backfire	适得其反	 [ˌbækˈfaɪə(r)] 
exhort	劝说	 [ɪgˈzɔ:t] 
congested	拥挤的	 [kənˈdʒestɪd] 
glean	收集	[gli:n] 
pastoral	牧师的	 [ˈpɑ:stərəl] 
hierarchy	层次	 [ˈhaɪərɑ:ki] 
patchy	有补丁的	 [ˈpætʃi] 
flush	冲刷，富足的	[flʌʃ] 
spite	向…表示恶意	[spaɪt]
exterminate	消灭	 [ɪkˈstɜ:mɪneɪt] 
matriculate	被大学录取	[məˈtrɪkjuleɪt]
adorn	装饰	 [əˈdɔ:n] 
redress	补偿，矫正	 [rɪˈdres] 
forage	尤指动物觅（食）	 [ˈfɒrɪdʒ] 
snivel	啜泣	[ˈsnɪvl]
avid	热心的，渴望的	 [ˈævɪd] 
digest	消化	[daɪˈdʒest] 
indigestion	消化不良	 [ˌɪndɪˈdʒestʃən] 
stipulate	规定	 [ˈstɪpjuleɪt] 
proliferation	增殖	 [prəˌlɪfəˈreɪʃn] 
indict	控告	[ɪnˈdaɪt]
assort	把…分类；相配	 [ə'sɔ:t] 
assorted	各式各样的	 [əˈsɔ:tɪd] 
complement	补充	 [ˈkɒmplɪment] 
complementary	补充的	 [ˌkɒmplɪˈmentri] 
conspire	搞阴谋	 [kənˈspaɪə(r)] 
booze	暴饮	 [bu:z] 
collate	校对	[kəˈleɪt] 
discreet	谨慎的	 [dɪˈskri:t] 
wean	使断奶	 [wi:n] 
florid	华丽的	 [ˈflɒrɪd] 
wobble	晃动	 [ˈwɒbl] 
cede	让给	 [si:d] 
adroit	机敏的	 [əˈdrɔɪt] 
pompous	华而不实的	 [ˈpɒmpəs]
gender	性别	 [ˈdʒendə(r)] 
engender	引起	 [ɪnˈdʒendə(r)] 
peculiar	特有的	 [pɪˈkju:liə(r)] 
germinate	使发芽	 [ˈdʒɜ:mɪneɪt] 
engross	使全神贯注	 [ɪnˈgrəʊs] 
spur	鞭策，马刺	[spɜ:(r)]
consensus	一致同意	 [kənˈsensəs]  
dissension	纠纷	 [dɪˈsenʃn] 
tinge	着色	[tɪndʒ] 
devolve	交给下属（或下层、晚辈等）	 [dɪˈvɒlv] 
ascertain	弄清	[ˌæsəˈteɪn]
ramble	漫步	[ˈræmbl]
mesmerize	迷惑	 [ˈmezməraɪz] 
qualm	不安	 [kwɑ:m] 
devastate	破坏	 [ˈdevəsteɪt] 
upfront	首要的	 [ˌʌpˈfrʌnt] 
downright	直截了当的	 [ˈdaʊnraɪt] 
genteel	上流社会的	 [dʒenˈti:l] 
drowse	打瞌睡	 [draʊz] 
ooze	渗出	 [u:z] 
replica	复制品	 [ˈreplɪkə] 
pious	虔诚的	 [ˈpaɪəs] 
symptom	症状	 [ˈsɪmptəm] 
impenetrable	不能理解的	 [ɪmˈpenɪtrəbl] 
agitate	鼓动	[ˈædʒɪteɪt] 
tarry	逗留，柏油的	 [ˈtæri] 
hiccup	打嗝，暂时性的小问题	['hɪkʌp] 
meddle	用手玩弄	 [ˈmedl] 
dawdle	混（时间）	 [ˈdɔ:dl] 
rue	对…感到后悔	 [ru:] 
infernal	地狱的	 [ɪnˈfɜ:nl] 
affable	平易近人的	 [ˈæfəbl] 
audacious	大胆创新的	[ɔ:ˈdeɪʃəs] 
stampede	惊逃	 [stæmˈpi:d] 
rustle	沙沙声	 [ˈrʌsl] 
debit	借方帐目，缺点	 [ˈdebɪt] 
hibernate	冬眠	 [ˈhaɪbəneɪt] 
faze	打扰	 [feɪz] 
flighty	（尤指女人或其行为）轻浮的	 [ˈflaɪti] 
espouse	拥护，嫁娶	[ɪˈspaʊz]
indolent	懒散的	 [ˈɪndələnt]
zenith	顶点	 [ˈzenɪθ] 
lull	使安静	[lʌl] 
literal	照字面的	 [ˈlɪtərəl] 
exasperate	使恶化	 [ɪgˈzæspəreɪt] 
impertinent	不相关的	[ɪmˈpɜ:tɪnənt] 
crease	弄皱	[kri:s] 
cohesive	有黏着力的	 [kəʊˈhi:sɪv] 
intelligible	明白易懂的	 [ɪnˈtelɪdʒəbl] 
heed	留心	 [hi:d] 
devout	虔诚的	 [dɪˈvaʊt]
potency	潜能，（男人的）性交能力	 [ˈpəʊtnsi] 
coexist	和平共处	 [ˌkəʊɪgˈzɪst] 
wreck	毁坏	 [rek] 
equitable	公正的	 [ˈekwɪtəbl] 
enrage	激怒	 [ɪnˈreɪdʒ] 
abstain	弃权，戒（尤指酒）	[əbˈsteɪn]
servile	过分屈从的	 [ˈsɜ:vaɪl] 
exuberant	生气勃勃的	 [ɪgˈzju:bərənt] 
rivet	铆钉	 [ˈrɪvɪt] 
exorable	可说服的	 ['eksərəbl] 
inexorable	无情的，不可动摇的	[ɪnˈeksərəbl] 
nimble	机敏的	 [ˈnɪmbl]
degrade	降低，降解，撤职	 [dɪˈgreɪd] 
cumbersome	笨重的	 [ˈkʌmbəsəm] 
meager	贫乏的;瘦的	 ['mi:gə]
captivate	迷住	 [ˈkæptɪveɪt] 
keel	（船的）龙骨，翻身	 [ki:l] 
essence	本质	 [ˈesns]
admissible	可容许的	 [ədˈmɪsəbl] 
veritable	名副其实的	 [ˈverɪtəbl]
flamboyant	艳丽的	 [flæmˈbɔɪənt] 
haywire	捆干草用的铁丝	 [ˈheɪwaɪə(r)] 
forlorn	绝望的	 [fəˈlɔ:n] 
befall	降临	[bɪˈfɔ:l] 
profiteer	投机	[ˌprɒfɪ'tɪər]
debilitate	使衰弱	 [dɪˈbɪlɪteɪt] 
ebb	（指潮水）退	 [eb] 
recompense	报酬	 [ˈrekəmpens]
expedient	应急办法	 [ɪkˈspi:diənt] 
hidebound	守旧的	 [ˈhaɪdbaʊnd] 
conflate	合并	[kənˈfleɪt] 
seep	渗透	[si:p]
partake	参与	 [pɑ:ˈteɪk]
scuffle	扭打	 [ˈskʌfl] 
resultant	因而发生的	 [rɪˈzʌltənt] 
volatile	（液体或油）易挥发的，不稳定的	[ˈvɒlətaɪl] 
facet	小平面	 [ˈfæsɪt] 
loathe	厌恶（某人、某事物）	 [ləʊð] 
elemental	基本的	[ˌelɪˈmentl] 
squawk	（尤指鸟受惊时）粗厉的叫声	 [skwɔ:k] 
decry	公开反对	 [dɪˈkraɪ] 
taint	玷污	 [teɪnt] 
resigned	已辞职的，顺从的	 [rɪˈzaɪnd]
mercy	怜悯，幸运	 [ˈmɜ:si] 
dupe	欺骗	 [dju:p] 
shuffle	洗牌，推诿，拖着脚走	 [ˈʃʌfl]
obscene	淫秽的	 [əbˈsi:n]
banish	驱逐	 [ˈbænɪʃ]
misbehave	行为不端	 [ˌmɪsbɪˈheɪv] 
observant	善于观察的	 [əbˈzɜ:vənt] 
arise	起身，出现，起源于	 [əˈraɪz] 
pertain	附属，适合，关于	 [pəˈteɪn]
clatter	咔哒声	[ˈklætə(r)] 
cringe	畏缩	 [krɪndʒ] 
whitewash	粉饰	 [ˈwaɪtwɒʃ]
repudiate	拒绝接受	[rɪˈpju:dieɪt]
consummate	使完美	 [ˈkɒnsəmeɪt] 
affinity	姻亲关系，（男女之间的）吸引力，类似	 [əˈfɪnəti]
obscurity	费解	[əbˈskjʊərəti] 
popularize	使受欢迎	 [ˈpɒpjələraɪz] 
futility	无效	[fju:'tɪlətɪ]
flaunt	炫耀	 [flɔ:nt] 
bogus	假冒的	 [ˈbəʊgəs] 
lax	松懈的，泻肚	[læks]
fester	化脓，溃烂	[ˈfestə(r)]
deform	变畸形	 [dɪˈfɔ:m] 
advocacy	辩护	[ˈædvəkəsi] 
itch	痒，渴望	[ɪtʃ] 
grant	授予，同意，补助金	 [grɑ:nt] 
abiding	持久的	 [əˈbaɪdɪŋ]
erudite	博学的	 [ˈerudaɪt] 
frantic	发狂的	 [ˈfræntɪk]
doodle	乱写乱画（出的东西）	[ˈdu:dl] 
ignoble	出身低微的，卑鄙的	 [ɪgˈnəʊbl]
agile	灵活的	 [ˈædʒaɪl] 
disputable	可争辩的	 [dɪˈspju:təbl] 
indisputable	不容置疑的	 [ˌɪndɪˈspju:təbl] 
exalt	提升;赞扬	 [ɪgˈzɔ:lt]
pinpoint	精准定位	 [ˈpɪnpɔɪnt] 
substantial	牢固的;重大的	 [səbˈstænʃl] 
unwind	解开，（使）心情轻松	 [ˌʌnˈwaɪnd] 
tractable	驯服的	 [ˈtræktəbl] 
negligible	微不足道的	 [ˈneglɪdʒəbl]
bombard	炮击，轰炸	 [bɒmˈbɑ:d] 
innate	天生的	 [ɪˈneɪt] 
defect	背叛，瑕疵	 [ˈdi:fekt] 
maculate	弄污	 ['mækjʊleɪt] 
immaculate	完美的	 [ɪˈmækjələt]
downhearted	心灰意冷	 [ˌdaʊnˈhɑ:tɪd] 
abominable	可恶的	 [əˈbɒmɪnəbl] 
expound	详细讲解	 [ɪkˈspaʊnd] 
disparate	完全不同的	 [ˈdɪspərət] 
peek	偷看	 [pi:k]
incite	煽动	 [ɪnˈsaɪt]
strain	拉紧，血统	 [streɪn] 
drone	雄蜂，无人驾驶飞机，嗡嗡声	 [drəʊn]
deface	使失面子	 [dɪˈfeɪs] 
sketch	素描	 [sketʃ] 
inexhaustible	用不完的	 [ˌɪnɪgˈzɔ:stəbl]
instantaneous	瞬间的	 [ˌɪnstənˈteɪniəs] 
attrition	消磨	 [əˈtrɪʃn] 
idiosyncrasy	（某人特有的）气质	 [ˌɪdiəˈsɪŋkrəsi] 
detect	查明	 [dɪˈtekt]
detest	憎恶	 [dɪˈtest]
prevalent	流行的	 [ˈprevələnt] 
outcast	被驱逐的人	[ˈaʊtkɑ:st]
evolve	使发展	 [iˈvɒlv]
impartial	不偏不倚的	 [ɪmˈpɑ:ʃl] 
seedy	多籽的，破烂的	 [ˈsi:di] 
scrutinize	仔细检查	 [ˈskru:tənaɪz] 
acute	敏锐的，严重的	 [əˈkju:t]
implore	乞求	 [ɪmˈplɔ:(r)]
balmy	温暖的;芳香的;	 [ˈbɑ:mi] 
bountiful	慷慨给予的	 [ˈbaʊntɪfl] 
irrevocable	不可改变的	 [ɪˈrevəkəbl] 
avert	转移;防止	 [əˈvɜ:t] 
invulnerable	无懈可击的	 [ɪnˈvʌlnərəbl]
neutralize	中和;使中立化;	 [ˈnju:trəlaɪz] 
poignant	（记忆）活鲜鲜的，辛酸的	 [ˈpɔɪnjənt]
tributary	支流;进贡国;附庸国;	 [ˈtrɪbjətri] 
enigmatic  	神秘的	 [ˌenɪgˈmætɪk]
fitful	一阵阵的	 [ˈfɪtfl] 
banal	平庸的	 [bəˈnɑ:l] 
insidious	阴险的	 [ɪnˈsɪdiəs] 
personify	拟人化，象征	[pəˈsɒnɪfaɪ] 
lurk	潜伏，欺骗	 [lɜ:k] 
mortality	死亡数，必死的命运	[mɔ:ˈtæləti] 
defraud	骗取	 [dɪˈfrɔ:d]
frivolous	轻率的，毫无意义的，孩子气的	 [ˈfrɪvələs] 
concur  	同意，同时发生	 [kənˈkɜ:(r)]
giddy	头晕的，轻浮的	 [ˈgɪdi] 
bash	猛击，严厉批评	 [bæʃ] 
spurious	伪造的，私生的	 [ˈspjʊəriəs] 
indubitable	不容置疑的	 [ɪn'dju:bɪtəbəl] 
wallow	打滚，堕落	 [ˈwɒləʊ] 
caress	爱抚，接吻	 [kəˈres] 
expropriate	剥夺…的所有权	[eksˈprəʊprieɪt]
knack	窍门	 [næk]
censor	监察官	 [ˈsensə(r)] 
disservice	虐待	 [dɪsˈsɜ:vɪs] 
apart	分离的	 [əˈpɑ:t] 
abide	容忍，逗留	 [əˈbaɪd] 
perturb	使（某人）烦恼	 [pəˈtɜ:b] 
meek	驯服的	 [mi:k] 
upsurge	高涨	[ˈʌpsɜ:dʒ] 
delineate	勾画	 [dɪˈlɪnieɪt] 
repel	抵制;使厌恶	 [rɪˈpel]
recurrent	复现的;周期性的	 [rɪˈkʌrənt] 
masquerade	化装舞会，伪装	 [ˌmæskəˈreɪd] 
outlay	花费	[ˈaʊtleɪ] 
wrest	（用力）拧	 [rest] 
degenerate	使退化，使变质	 [dɪˈdʒenəreɪt] 
antipathy	反感	 [ænˈtɪpəθi] 
literally	照字面地，确实地	 [ˈlɪtərəli] 
exhilarate	使高兴	 [ɪgˈzɪləreɪt] 
juncture	关键时刻	 [ˈdʒʌŋktʃə(r)] 
implicit	绝对的;成为一部份的	[ɪmˈplɪsɪt]
bluff	吓唬，直率的，陡峭的，悬崖	[blʌf] 
materialize	使具体化	 [məˈtɪəriəlaɪz] 
radiantly	辉煌地	 ['reɪdɪəntlɪ] 
undersell	以低于市价售出	[ˌʌndəˈsel]
consign	委托，当作	[kənˈsaɪn] 
restitution	恢复原状;补偿	 [ˌrestɪˈtju:ʃn] 
interpose	插（话）	 [ˌɪntəˈpəʊz] 
rein	驾驭，统治手段	 [reɪn] 
sustain	维持，忍受	 [səˈsteɪn]
dehydrate	使脱水	 [di:ˈhaɪdreɪt] 
disinterested	不感兴趣的；公正的	 [dɪsˈɪntrəstɪd] 
contrive	谋划	 [kənˈtraɪv] 
extort	敲诈;曲解	 [ɪkˈstɔ:t] 
fleeting	飞逝的	 [ˈfli:tɪŋ] 
infirmity	体弱;疾病	 [ɪnˈfɜ:məti] 
appease	对…让步	[əˈpi:z] 
trample	践踏	 [ˈtræmpl]
mania	狂热	 [ˈmeɪniə] 
headway	进展	 [ˈhedweɪ] 
nominal	名义上的	 [ˈnɒmɪnl] 
evade	逃避	 [ɪˈveɪd] 
inept	笨拙的	 [ɪˈnept] 
incur	招致	 [ɪnˈkɜ:(r)] 
obsess	使着迷	[əbˈses] 
squint	斜视	 [skwɪnt] 
makeshift	临时替代品	 [ˈmeɪkʃɪft]
empathy	同感	 [ˈempəθi]
pageant	盛会	 [ˈpædʒənt] 
conciliate	使（某人）息怒或友好，（使）意见一致	[kənˈsɪlieɪt] 
presume	推测，擅自行动	 [prɪˈzju:m]
hobble	蹒跚	 [ˈhɒbl] 
sundry	各式各样的	[ˈsʌndri] 
bashful	羞怯的	 [ˈbæʃfl] 
fiasco	惨败	 [fiˈæskəʊ] 
afoot	徒步的（地）;正在进行的（地）;不对劲的（地）	 [əˈfʊt] 
flagrant	明目张胆的;臭名远扬的	 [ˈfleɪgrənt] 
harness	马具，控制	 [ˈhɑ:nɪs]
insipid	枯燥的	 [ɪnˈsɪpɪd] 
deviate	脱离常轨的	 [ˈdi:vieɪt] 
sleek	圆滑的，长得好的	[sli:k] 
fractious	易怒的	 [ˈfrækʃəs]
methodical	有条不紊的	 [məˈθɒdɪkl]
fingertip	指尖	 [ˈfɪŋgətɪp] 
jumbo	庞大的	 [ˈdʒʌmbəʊ] 
sag	下垂	 [sæɡ] 
empower	授权，使控制局势	 [ɪmˈpaʊə(r)]
countenance	表情，赞同	 [ˈkaʊntənəns] 
muddle	弄乱，使糊涂，混日子	 [ˈmʌdl] 
granular	颗粒状的	[ˈgrænjələ(r)] 
luxuriant	茂盛的	 [lʌgˈʒʊəriənt] 
feverish	发烧的，高度活跃或兴奋的	[ˈfi:vərɪʃ] 
relieve	缓解，（去厕所的一种委婉说法）方便	 [rɪˈli:v] 
anew	重新	[əˈnju:] 
improvise	即兴创作	 [ˈɪmprəvaɪz]
aggrieved	受委屈的	[əˈgri:vd]
foreshadow	是…的先兆	 [fɔ:ˈʃædəʊ] 
undercharge	过低的索价;不足量的充填	 [ˌʌndəˈtʃɑ:dʒ] 
overstate	夸大（某事）	 [ˌəʊvəˈsteɪt] 
ignominy	污辱	 [ˈɪgnəmɪni] 
blatant	公然的	 [ˈbleɪtnt] 
defuse	使变为无害	 [ˌdi:ˈfju:z] 
perilous	危险的	 [ˈperələs]
flippant	轻浮的	 [ˈflɪpənt] 
rapt	入迷的	 [ræpt] 
endorse	签名，开发票	 [ɪnˈdɔ:s]
seethe	生闷气，翻滚，充满	 [si:ð]
chuck	扔出，咕咕（咯咯、嘟嘟）地叫，（美国）辞职	 [tʃʌk]
liquid	液体的;清澈的;（声音）流畅的;易转换成现款的	 [ˈlɪkwɪd] 
liquidate	清算，换现款	 [ˈlɪkwɪdeɪt] 
crackle	破裂	[ˈkrækl]
proximity	亲近;接近	 [prɒkˈsɪməti] 
postulate	假定	 [ˈpɒstjuleɪt] 
muse	默想	[mju:z] 
hulk	残骸	 [hʌlk] 
hulking	笨拙的	 [ˈhʌlkɪŋ] 
lenient	宽大的，减轻痛苦的	 [ˈli:niənt] 
disconcert	使不安	 [ˌdɪskənˈsɜ:t] 
amass	积累	[əˈmæs] 
spasm	抽搐;发作	 [ˈspæzəm] 
obesity	肥胖	 [əʊ'bi:sətɪ]
coerce	强制	 [kəʊˈɜ:s] 
ordain	（上帝、法律等）命令	 [ɔ:ˈdeɪn] 
deify  	把…奉若神明	 [ˈdeɪɪfaɪ]
salutary	效果好的	 [ˈsæljətri] 
ethereal	轻飘的，乙醚的	 [iˈθɪəriəl] 
contend	争斗，主张	[kənˈtend] 
imperious	飞扬跋扈的	 [ɪmˈpɪəriəs] 
redundant	多余的，失业的	[rɪˈdʌndənt] 
discretion	考虑周到，判断力	 [dɪˈskreʃn]
numb	麻木的	 [nʌm]
callow	幼小的	 [ˈkæləʊ] 
intricacy	错综复杂	 [ˈɪntrɪkəsi] 
myriad	无数的	 [ˈmɪriəd] 
whoop	呐喊，喘息声	 [wu:p] 
obsessive	着迷的，强迫性的	[əbˈsesɪv]
evacuate	疏散	 [ɪˈvækjueɪt] 
bicker	争吵，（水的）潺潺声	 [ˈbɪkə(r)] 
chic	别致的	 [ʃi:k] 
balk	假动作，拒绝，阻碍，过错	 [bɔ:k] 
inflame	（使）发怒，使发炎	 [ɪnˈfleɪm] 
mercenary	唯利是图者，雇佣兵	 [ˈmɜ:sənəri] 
harrowing	耙地，令人伤心的	 [ˈhærəʊɪŋ] 
unfailing	永恒的;可靠的	 [ʌnˈfeɪlɪŋ] 
snarl	咆哮，混乱	 [snɑ:l] 
damp	潮湿的	 [dæmp] 
dampen	使潮湿;使…沮丧;隔音	 [ˈdæmpən] 
rupture	破裂，疝气	 [ˈrʌptʃə(r)]
carve	雕刻	[kɑ:v]
carven	雕刻的	['kɑ:vn]
scanty	（大小或数量）不足的	 [ˈskænti] 
brow	眉，前额	 [braʊ] 
highbrow	高雅的	 [ˈhaɪbraʊ]
recount	重新计算;详细叙述	 [rɪ'kaʊnt]
crux	症结	[krʌks] 
gurgle	咯咯声	 [ˈgɜ:gl] 
fortify	加强	[ˈfɔ:tɪfaɪ] 
rectify	改正	 [ˈrektɪfaɪ] 
faint	昏厥	 [feɪnt] 
virulent	剧毒的	 [ˈvɪrələnt]
tantamount	相等的	 [ˈtæntəmaʊnt] 
incumbent	在职的;靠在[压在]上面的;弯垂下来的	 [ɪnˈkʌmbənt] 
unaccountable	不负责任的，不能理解的	[ˌʌnəˈkaʊntəbl] 
energize	给与…以活力	[ˈenədʒaɪz] 
implant	植入	 [ɪmˈplɑ:nt] 
commensurate	（在时间和空间上）相等的	 [kəˈmenʃərət] 
incursion	侵入，（河水等）流入	 [ɪnˈkɜ:ʃn] 
feint	佯攻	 [feɪnt] 
plea	恳求，（被告或被告律师的）抗辩	 [pli:] 
reprimand	谴责	 [ˈreprɪmɑ:nd] 
irreverent	不敬的	 [ɪˈrevərənt]
gaunt	憔悴的;荒凉的	 [gɔ:nt] 
convertible	可改变的;（货币）可以自由兑换的，敞篷车	 [kənˈvɜ:təbl] 
tinker	粗劣的修补	 [ˈtɪŋkə(r)] 
extricate	解脱	 [ˈekstrɪkeɪt] 
haste	匆忙	 [heɪst] 
havoc	大破坏	 [ˈhævək] 
squabble	争论	 [ˈskwɒbl] 
grandiose	宏伟的;浮夸的	 [ˈgrændiəʊs] 
jostle	推挤;竞争	 [ˈdʒɒsl] 
overshadow	使阴暗	 [ˌəʊvəˈʃædəʊ] 
sterile	无菌的，贫瘠的，不生育的	[ˈsteraɪl] 
halt	停止	 [hɔ:lt] 
curt	草率的	 [kɜ:t] 
factitious	人造的	 [fækˈtɪʃəs] 
premature	早产的	 [ˈpremətʃə(r)] 
warrant	许可证，辩解	 [ˈwɒrənt] 
scavenge	打扫;（在废物中）寻觅	 [ˈskævɪndʒ] 
cowardice	懦弱	 [ˈkaʊədɪs]
intrusive	侵入的	 [ɪnˈtru:sɪv] 
gruff	生硬的;（声音）粗哑的;（人的行为）冷淡的	 [grʌf] 
entity	实体	[ˈentəti] 
capitulate	认输	 [kəˈpɪtʃuleɪt] 
covet	贪求	 [ˈkʌvət] 
swear	咒骂	 [sweə(r)] 
aboveboard	正大光明的	[ə'bʌv'bɔ:d] 
benevolent	好心肠的	 [bəˈnevələnt] 
transient	临时的，候鸟	[ˈtrænziənt]
matrix	矩阵，模型，母体，子宫	[ˈmeɪtrɪks]
sulk	生气	 [sʌlk] 
sovereign	最高统治者	 [ˈsɒvrɪn] 
paradoxical	荒谬的	 [ˌpærə'dɒksɪkl] 
hype	夸张地宣传（某人或某事物）	 [haɪp] 
deluxe	豪华的	 [də'lʌks]
generic	一般的，不受商标保护的	 [dʒəˈnerɪk]
equable	稳定的	 [ˈekwəbl] 
raft	木筏，大量	[rɑ:ft]
deposit	储蓄，寄存，付保证金，沉淀	 [dɪˈpɒzɪt]
shirk	逃避（工作）	 [ʃɜ:k] 
butt	烟蒂，屁股，笑柄，碰撞	 [bʌt] 
deem	认为	 [di:m] 
incriminate	控告	 [ɪnˈkrɪmɪneɪt] 
attribute	把…归于，属性	 [əˈtrɪbju:t]
tumultuous	骚乱的	 [tju:ˈmʌltʃuəs]
farsighted	有远见的	 ['fɑ:'saɪtɪd] 
implacable	（指愤怒、仇恨、敌意等）难和解的	 [ɪmˈplækəbl] 
irk	使烦恼	 [ɜ:k] 
hectic	忙乱的，狂热的，（因患肺病等）发烧的	 [ˈhektɪk]
embroil	使（自己或他人）卷入纠纷	 [ɪmˈbrɔɪl] 
uproot	根除	 [ˌʌpˈru:t] 
interlude	插曲	[ˈɪntəlu:d] 
quell	消除，镇压，使镇定	 [kwel] 
overwhelm	压垮，覆盖	[ˌəʊvəˈwelm]
magnitude	量级;巨大	 [ˈmægnɪtju:d] 
recur	复发	 [rɪˈkɜ:(r)] 
discredit	不信，败坏…的名声	 [dɪsˈkredɪt] 
replenish	把…装满	 [rɪˈplenɪʃ]
unpalatable	味道差的	 [ʌnˈpælətəbl] 
flail	抽打，扫雷装置	 [fleɪl] 
malpractice	弊端，治疗不当	 [ˌmælˈpræktɪs] 
plumb	探索，使垂直，做管道工，铅锤	 [plʌm] 
distraught	忧心如焚的	 [dɪˈstrɔ:t] 
affront	（当众）侮辱	 [əˈfrʌnt] 
secrete	分泌，隐匿	 [sɪˈkri:t]
disprove	证明…是虚假的	 [ˌdɪsˈpru:v] 
undertake	承诺，从事	 [ˌʌndəˈteɪk]
quail	鹌鹑，使沮丧，使畏缩	[kweɪl]
irreconcilable	（观点、目标或争议）不可调和的	 [ɪˈrekənsaɪləbl] 
nip	掐，冻伤，（酒等的）一口，寒意	 [nɪp] 
summit	高层会议;最高阶层	 [ˈsʌmɪt] 
furl	卷收	 [fɜ:l] 
slump	暴跌	 [slʌmp]
dissolve	使溶解	 [dɪˈzɒlv] 
hypothesis	假设	 [haɪˈpɒθəsɪs] 
revoke	废除，有牌不跟	 [rɪˈvəʊk]
heinous	极邪恶的	 [ˈheɪnəs] 
hilarious	令人捧腹的	 [hɪˈleəriəs] 
rough	粗糙的，狂暴的，草拟	 [rʌf] 
flinch	退缩	 [flɪntʃ] 
idolize	将（某人）当作偶像崇拜	 [ˈaɪdəlaɪz] 
venom	（某些蛇、蝎子等分泌的）毒液	 [ˈvenəm]
unfathomable	高深莫测的	 [ʌnˈfæðəməbl] 
opt	选择	 [ɒpt] 
fret	回纹饰，烦躁，磨损处	 [fret] 
efface	擦掉;超越	[ɪˈfeɪs] 
align	使成一线，使结盟	 [əˈlaɪn] 
floppy	松软的;懒散的	 [ˈflɒpi] 
literate	有文化修养的	 [ˈlɪtərət] 
regress	退化;逆行	[rɪˈgres]
intransigent	不让步的	 [ɪnˈtrænsɪdʒənt] 
decadent	颓废的	 [ˈdekədənt] 
repentance	悔改	 [rɪˈpentəns] 
interrogate	审问	[ɪnˈterəgeɪt] 
grace	优雅	 [greɪs] 
irreparable	不可弥补的	 [ɪˈrepərəbl] 
interval	间隔	 [ˈɪntəvl]
treacherous	不忠的	 [ˈtretʃərəs] 
loot	抢劫，（官吏）贪污	 [lu:t] 
flout	嘲笑	 [flaʊt] 
decipher	破译（密码）	 [dɪˈsaɪfə(r)] 
contingent	依情况而定的，代表团	 [kənˈtɪndʒənt] 
impregnable	坚不可摧的	 [ɪmˈpregnəbl] 
morbid	病态的，恐怖的	 [ˈmɔ:bɪd]
hypercritical	（尤指对小错误）吹毛求疵的	 ['haɪpə'krɪtɪkəl] 
discrete	不相关联的	 [dɪˈskri:t] 
hearten	振作	 [ˈhɑ:tn] 
irreducible	不能减少的	 [ˌɪrɪˈdju:səbl] 
indiscreet	轻率的	 [ˌɪndɪˈskri:t] 
detour	绕道	 [ˈdi:tʊə(r)] 
misapprehend	误会	 ['mɪsˌæprɪ'hend] 
huff	吹，恼怒，使膨胀	 [hʌf]
censure	指责	 [ˈsenʃə(r)] 
escalate	逐步上升	 [ˈeskəleɪt] 
camouflage	伪装	 [ˈkæməflɑ:ʒ] 
gratify	使高兴	 [ˈgrætɪfaɪ] 
heredity	遗传	[həˈredəti]
prophesy	预言	 [ˈprɒfəsaɪ] 
muster	集合，检阅，花名册，激起	[ˈmʌstə(r)]
gripe	抱怨，紧握，绞痛	 [graɪp] 
tamper	篡改，贿赂	 [ˈtæmpə(r)]
hamper	妨碍	 [ˈhæmpə(r)]
hapless	倒霉的	 [ˈhæpləs]
mar	玷污	[mɑ:(r)] 
panacea	治百病的药	 [ˌpænəˈsi:ə]
deft	灵巧的	[deft] 
martial	战争的	 [ˈmɑ:ʃl] 
bereaved	刚刚丧失亲人的	 [bɪˈri:vd] 
refute	驳斥	 [rɪˈfju:t]
defame	诽谤	 [dɪˈfeɪm] 
pungent	尖刻的	 [ˈpʌndʒənt]
impressionable	（人，尤指年轻人）易受影响的	 [ɪmˈpreʃənəbl] 
diffident	羞怯的	 [ˈdɪfɪdənt] 
rummage	翻查，杂物	 [ˈrʌmɪdʒ]
requisite	必需品	[ˈrekwɪzɪt] 
legible	易读的	 [ˈledʒəbl] 
throb	脉搏;跳动	 [θrɒb] 
stark	完全的;荒凉的;光秃秃的	[stɑ:k]
converge	聚集	 [kənˈvɜ:dʒ] 
fanciful	（指人）富于幻想的，稀奇的	 [ˈfænsɪfl] 
insanity	精神病	 [ɪnˈsænəti] 
coax	哄骗	[kəʊks] 
extent	程度;长度;广大地域;扣押	 [ɪkˈstent] 
sultry	性感的;（指天气）湿热难耐的	 [ˈsʌltri] 
emblem	象征	 [ˈembləm]
replicate	复制	[ˈreplɪkeɪt] 
hoodwink	欺诈	 [ˈhʊdwɪŋk]
incessant	不停的	 [ɪnˈsesnt] 
harangue	高谈阔论	[həˈræŋ] 
scour	冲刷，四处搜索，（用泻药）泻	 [ˈskaʊə(r)] 
impasse	僵局，死路	 [ˈæmpɑ:s] 
decompose	分解;（使）腐烂	 [ˌdi:kəmˈpəʊz] 
manoeuvre	调遣，操纵，伎俩	[məˈnu:və(r)] 
artful	有技巧的	 [ˈɑ:tfl] 
charisma	魅力	 [kəˈrɪzmə] 
fatuous	愚昧的	[ˈfætʃuəs] 
perceptible	可理解的	[pəˈseptəbl] 
ardent	热情的，热烈的	 [ˈɑ:dnt] 
contort	扭曲	 [kənˈtɔ:t]
airy	通风的;轻快的;空气的	 [ˈeəri] 
shear	剪切	 [ʃɪə(r)] 
liberate	解放	 [ˈlɪbəreɪt] 
deliberate	蓄意的	 [dɪˈlɪbərət]
emulate	仿真，努力赶上	 [ˈemjuleɪt] 
infest	骚扰;成群出现;在…上寄生	 [ɪnˈfest] 
lapse	失足，失效，堕入	 [læps] 
dissuade	劝阻	 [dɪˈsweɪd] 
recourse	求援;所依靠的物[人]	[rɪˈkɔ:s] 
fraudulent	不诚实的	 [ˈfrɔ:djələnt] 
snag	妨碍;被戳坏	 [snæg] 
impale	钉在尖桩上	[ɪmˈpeɪl] 
depreciate	轻视;贬值	 [dɪˈpri:ʃieɪt] 
lavish	挥霍	[ˈlævɪʃ] 
detract	减损，贬低，转移（注意等）	 [dɪˈtrækt] 
omniscient	无所不知的	[ɒmˈnɪsiənt]
pseudo	虚伪的	 ['sju:dəʊ] 
predicament	困境，范畴	[prɪˈdɪkəmənt]
senile	衰老的	 [ˈsi:naɪl] 
enthrall	吸引住;使感到非常愉快	 [ɪn'θrɔ:l] 
jerky	忽动忽停的;愚蠢的;肉干	 [ˈdʒɜ:ki] 
lunge	突然刺（入）	[lʌndʒ] 
fallible	容易犯错的	 [ˈfæləbl] 
intangible	难以理解的，（指企业资产）无形的	[ɪnˈtændʒəbl] 
surrender	投降	 [səˈrendə(r)] 
annihilate	歼灭	 [əˈnaɪəleɪt]
ghastly	可怕的;（脸色）苍白的	 [ˈgɑ:stli] 
wriggle	扭动，摆脱	 [ˈrɪgl] 
manifesto	宣言	 [ˌmænɪˈfestəʊ]
abate	减轻，失效，折扣	 [əˈbeɪt] 
baleful	凶恶的	 [ˈbeɪlfl] 
perception	知觉，（农作物的）收获	[pəˈsepʃn]
harrow	耙，使苦恼	 [ˈhærəʊ] 
dab	少许，是…能手，快速擦拭	 [dæb]
supersede	取代，推迟行动，废弃	 [ˌsu:pəˈsi:d]
inquisition	调查	 [ˌɪnkwɪˈzɪʃn] 
tacit	心照不宣的，由法律的效力而产生的	 [ˈtæsɪt] 
waive	放弃（权利、要求等）	 [weɪv] 
abrupt	陡峭的，意外的	 [əˈbrʌpt]
avail	有益于	 [əˈveɪl] 
ensue	继而产生	 [ɪnˈsju:] 
august	令人敬畏的	 [ɔ:ˈgʌst] 
corpulent	发福的	 [ˈkɔ:pjələnt] 
jab	猛刺	 [dʒæb] 
semblance	类似;外表;假装;副本	 [ˈsembləns] 
offhand	不友好的，即席地，未经核实地	 [ˌɒfˈhænd] 
wicked	邪恶的，淘气的	 [ˈwɪkɪd] 
exemplary	示范的	 [ɪgˈzempləri] 
counterbalance	对…起平衡作用，抵消	[ˌkaʊntəˈbæləns] 
divulge	暴露;揭发	[daɪˈvʌldʒ]
reprove	责骂	 [rɪˈpru:v] 
gabble	急促不清的话	 [ˈgæbl]
reckon	估计	 [ˈrekən] 
rationalize	使合理化	 [ˈræʃnəlaɪz] 
dainty	精致的	 [ˈdeɪnti] 
propel	推动	 [prəˈpel] 
gregarious	爱交际的	 [grɪˈgeəriəs] 
bulge	凸出;膨胀;急增	 [bʌldʒ] 
correlate	相关的	 [ˈkɒrəleɪt] 
eerie	怪异的	[ˈɪəri] 
hump	（驼）峰	 [hʌmp] 
cramp	抽筋，夹子，难懂的，受拘束的	 [kræmp] 
redraw	重画;刷新屏幕	 [ˌri:ˈdrɔ:] 
reorient	使适应	 [ˌri:'ɔ:rɪent] 
dapper	（尤指男子）整洁漂亮的	 [ˈdæpə(r)] 
extradite	引渡（外国的罪犯）	 [ˈekstrədaɪt] 
accentuate	强调	 [əkˈsentʃueɪt]
bizarre	离奇的	 [bɪˈzɑ:(r)] 
venerate	崇敬	 [ˈvenəreɪt] 
stumble	蹒跚，结巴，弄错，失败	 [ˈstʌmbl] 
credentials	证书	 [krəˈdenʃlz] 
erratic	飘忽不定的，行为古怪，反复无常	 [ɪˈrætɪk] 
constancy	持续性	 [ˈkɒnstənsi] 
illustrious	辉煌的	 [ɪˈlʌstriəs]
pervade	弥漫，渗透，充满	 [pəˈveɪd] 
errant	行为不当的，对配偶不忠的	 [ˈerənt] 
peripheral	外围的;次要的;	 [pəˈrɪfərəl] 
ingenuous	坦率的	 [ɪnˈdʒenjuəs] 
hector	吓唬，暴徒	 [ˈhektə(r)] 
lucid	神志清醒的，清澈的	 [ˈlu:sɪd]
lush	丰富的，醉汉	 [lʌʃ] 
transfigure	美化	 [trænsˈfɪgə(r)] 
spout	喷射;滔滔不绝地讲	 [spaʊt] 
prolific	富饶的;（艺术家、作家等）多产的	 [prəˈlɪfɪk] 
protracted	拖延的	[prəˈtræktɪd]
incise	（在表面）雕	 [ɪnˈsaɪz] 
cursory	草率的	 [ˈkɜ:səri] 
ludicrous	荒唐的	 [ˈlu:dɪkrəs] 
disparity	不一致	 [dɪˈspærəti] 
irascible	易怒的;	 [ɪˈræsəbl] 
transfuse	输（血或别的液体）;渗透	 [træns'fju:z] 
mellow	（使）成熟;变柔和;使芳醇	 [ˈmeləʊ]
transcend	超越	 [trænˈsend] 
seduce	诱奸（妇女）;诱使…堕落	 [sɪˈdju:s] 
irrepressible	压抑不住的	 [ˌɪrɪˈpresəbl]
dispensable	非必需的	 [dɪˈspensəbl] 
impending	即将发生的，悬挂的	 [ɪmˈpendɪŋ] 
beckon	（用头或手的动作）示意	 [ˈbekən] 
segregate	隔离	[ˈsegrɪgeɪt] 
pounce	猛扑	 [paʊns]
fend	谋生，挡开	 [fend] 
intrigue	阴谋，奸情，激起…的好奇心	[ɪnˈtri:g] 
whisk	搅拌，掸，飞奔	 [wɪsk] 
pretentious	狂妄的，虚伪的	[prɪˈtenʃəs] 
rudimentary	基本的，未成熟的	 [ˌru:dɪˈmentri] 
blurt	脱口而出，漏出	 [blɜ:t] 
retaliate	报复	 [rɪˈtælieɪt]
hassle	争论，使…烦恼	 [ˈhæsl] 
conjecture	推测	 [kənˈdʒektʃə(r)] 
perceptive	有知觉力的	 [pəˈseptɪv] 
snuff	熄灭，吸入	 [snʌf] 
incoherent	支离破碎的	 [ˌɪnkəʊˈhɪərənt] 
convulse	使抽搐	 [kənˈvʌls] 
entreat	恳求	 [ɪnˈtri:t] 
eavesdrop	偷听	 [ˈi:vzdrɒp] 
swivel	（使）旋转	 [ˈswɪvl] 
extraneous	无关的;外来的	[ɪkˈstreɪniəs] 
inescapable	不可避免的	 [ˌɪnɪˈskeɪpəbl] 
versatility	多用途;	 [ˌvɜ:sə'tɪlətɪ] 
defoliate	（使）落叶	 [ˌdi:ˈfəʊlieɪt] 
prospective	预期的	 [prəˈspektɪv] 
obliterate	使消失	 [əˈblɪtəreɪt] 
shred	碎片	 [ʃred] 
centralize	使集中	 [ˈsentrəlaɪz] 
sufferance	忍耐	 [ˈsʌfərəns] 
mash	捣碎，糊状物，调情	[mæʃ] 
swoop	飞扑	 [swu:p]
condescend	屈尊	 [ˌkɒndɪˈsend] 
domesticate	驯养，适应家庭生活	 [dəˈmestɪkeɪt]
painstaking	辛苦的	[ˈpeɪnzteɪkɪŋ] 
tout	侦查者;招揽员	 [taʊt] 
husky	强壮的;嗓子哑的;有壳的;哈士奇	 [ˈhʌski] 
agonizing	痛苦难忍的	 [ˈægənaɪzɪŋ]
superimpose	添加	 [ˌsu:pərɪmˈpəʊz] 
cater	提供饮食及服务，满足需要	[ˈkeɪtə(r)] 
fetter	给…上脚镣	 [ˈfetə(r)] 
twist	转动，被搓揉	 [twɪst] 
wreathe	（完全地）笼罩	 [ri:ð] 
indisposed	不舒服的	 [ˌɪndɪˈspəʊzd] 
itemize	列出清单	 [ˈaɪtəmaɪz] 
hoary	灰白;古老的	 [ˈhɔ:ri] 
shun	避开	 [ʃʌn] 
premium	额外费用;优质的	 [ˈpri:miəm] 
novelty	新奇的事物	 [ˈnɒvlti] 
remorse	悔恨	 [rɪˈmɔ:s] 
retrospect	回顾	 [ˈretrəspekt] 
haggard	憔悴的，难驾驭的人	 [ˈhægəd] 
boisterous	喧闹的	[ˈbɔɪstərəs] 
intermingle	（使）混合	 [ˌɪntəˈmɪŋgl] 
heartrending	令人悲痛的;	 ['hɑ:tˌrendɪŋ] 
luscious	美味的;十分性感的	 [ˈlʌʃəs] 
livid	铁青	 [ˈlɪvɪd] 
languish	憔悴	 [ˈlæŋgwɪʃ]
forego	摒弃	[fɔ:ˈɡəu] 
egocentric	自我中心的	 [ˌegəʊˈsentrɪk] 
decelerate	（使）减速	 [ˌdi:ˈseləreɪt] 
preoccupied	全神贯注的	 [priˈɒkjupaɪd] 
cumulative	累积的	 [ˈkju:mjələtɪv] 
highhanded	专横的	 ['haɪ'hændɪd]
capsize	使（船或车）翻	 [kæpˈsaɪz] 
odds	可能性，掣肘的事情	 [ɒdz] 
ejaculate	射出;突然的喊出	 [iˈdʒækjuleɪt] 
resurrect	复活	 [ˌrezəˈrekt]
proposition	建议	 [ˌprɒpəˈzɪʃn] 
ardo(u)r	热情	 ['ɑ:də]
elucidate	阐明	 [iˈlu:sɪdeɪt] 
precarious	危险的;不确定的;	 [prɪˈkeəriəs] 
loll	懒洋洋地躺着[坐着、站着]	 [lɒl] 
mutilate	切断（手足等）;毁坏	 [ˈmju:tɪleɪt] 
dictate	口述;命令;使听写	 [dɪkˈteɪt] 
clinch	（尤指两人）互相紧紧抱[扭]住，达成（协议），钳子,敲弯	 [klɪntʃ] 
gloss	光泽，注释，假象	 [glɒs] 
forsake	放弃	 [fəˈseɪk] 
supplant	取代	 [səˈplɑ:nt] 
preclude	排除;阻止	[prɪˈklu:d]
sidle	悄悄地走	 [ˈsaɪdl] 
repine	苦恼	 [rɪ'paɪn] 
forfeit	丧失了的，被没收了的	 [ˈfɔ:fɪt] 
corroborate	证实，使加强	 [kəˈrɒbəreɪt] 
potent	有效的，强有力的	 [ˈpəʊtnt] 
paralysis	瘫痪	 [pəˈræləsɪs] 
wring	拧，感到痛苦	[rɪŋ]
quizzical	疑问的，戏弄的	 [ˈkwɪzɪkl] 
endow	捐赠，赐予	 [ɪnˈdaʊ] 
fudge	软糖;梦话;欺骗	 [fʌdʒ] 
infallible	可靠的事物	 [ɪnˈfæləbl] 
constrain	约束;强迫	 [kənˈstreɪn]
adjoin	邻近，使结合	 [əˈdʒɔɪn] 
pedantic	卖弄学问的	[pɪˈdæntɪk]
multilateral	多边的	 [ˌmʌltiˈlætərəl] 
heterodox	异端的	 [ˈhetərədɒks] 
acquiesce	默认的	[ˌækwiˈes] 
outspoken	坦率的;	 [aʊtˈspəʊkən] 
heresy	异端邪说	 [ˈherəsi] 
legitimize	使合法化	 [lɪˈdʒɪtəmaɪz] 
prodigal	挥霍的;	 [ˈprɒdɪgl] 
apathy	冷淡	[ˈæpəθi] 
entice	诱惑	 [ɪnˈtaɪs] 
precipitous	险峻的;急躁的	[prɪˈsɪpɪtəs] 
deterrent	制止的	 [dɪˈterənt] 
gaiety	快乐	[ˈgeɪəti] 
illicit	非法的	 [ɪˈlɪsɪt]
slimy	黏滑的;谄媚的	 [ˈslaɪmi] 
slug	鼻涕虫，子弹，动作迟缓	 [slʌg]
capricious	多变的	 [kəˈprɪʃəs] 
repulse	击败	 [rɪˈpʌls] 
fiscal	财政上的，检察官	 [ˈfɪskl] 
vicarious	（想像别人苦乐情况）间接体验的;代理的	 [vɪˈkeəriəs]
accredit	归因于;委托;鉴定合格;认可	 [əˈkredɪt]
virtue	美德;长处	 [ˈvɜ:tʃu:] 
mumble	抿着嘴嚼，含糊的话	 [ˈmʌmbl]
woo	求爱，争取…的支持	 [wu:]
taunt	嘲弄	 [tɔ:nt] 
optimum	最适宜的	 [ˈɒptɪməm] 
superfluous	多余的	 [su:ˈpɜ:fluəs] 
sidestep	躲避，台阶	[ˈsaɪdstep] 
expunge	消除	 [ɪkˈspʌndʒ] 
oblivion	遗忘;淹没;赦免	[əˈblɪviən] 
paralytic	瘫痪的	[ˌpærəˈlɪtɪk] 
delimit	限制	 [diˈlɪmɪt]
dilapidated	残破的	[dɪˈlæpɪdeɪtɪd] 
abusive	虐待的;滥用的;骂人的	 [əˈbju:sɪv] 
deride	嘲弄	 [dɪˈraɪd] 
relentless	不懈的	 [rɪˈlentləs] 
ceremonious	讲究礼节的	 [ˌserəˈməʊniəs] 
nibble	啃，显出有兴趣	 [ˈnɪbl] 
execrable	讨厌的	 [ˈeksɪkrəbl] 
respite	使休息;暂缓;	 [ˈrespaɪt] 
budge	让步，羔羊皮	 [bʌdʒ]
nutrient	养分	 [ˈnju:triənt]
prerequisite	先决条件	 [ˌpri:ˈrekwəzɪt] 
convene	召集	 [kənˈvi:n] 
plummet	垂直落下，铅锤	 [ˈplʌmɪt] 
maladjusted	失调的	 [ˌmæləˈdʒʌstɪd] 
domineer	压制	 [ˌdɒmɪ'nɪə] 
quaver	颤音	 [ˈkweɪvə(r)] 
intrinsic	本质的	 [ɪnˈtrɪnsɪk] 
stalwart	坚定的;强壮的	 [ˈstɔ:lwət] 
misappropriate	盗用	 [ˌmɪsəˈprəʊprieɪt]
mesh	网状物;陷阱;啮合	 [meʃ]
dilate	扩大;详述	 [daɪˈleɪt] 
impair	削弱	 [ɪmˈpeə(r)] 
dislodge	把…逐出	 [dɪsˈlɒdʒ] 
obligatory	义务的	 [əˈblɪgətri] 
stalemate	僵局	 [ˈsteɪlmeɪt] 
delude	欺骗	 [dɪˈlu:d] 
infuse	加入（一种特性）;使充满;鼓舞;泡（草药）	 [ɪnˈfju:z] 
hackle	梳理，锯齿形	 ['hækl] 
hanker	渴求	 [ˈhæŋkə(r)]
toss	投掷，掷硬币决定，摇匀，猛仰头	 [tɒs] 
ponder	仔细考虑	 [ˈpɒndə(r)] 
invincible	无敌的	[ɪnˈvɪnsəbl] 
gush	喷涌	 [gʌʃ] 
ongoing	进行的	 [ˈɒngəʊɪŋ] 
yank	急拉	 [jæŋk] 
bemused	困惑的	 [bɪˈmju:zd] 
burrow	挖洞，翻寻	 [ˈbʌrəʊ] 
prescribe	规定，开处方	 [prɪˈskraɪb] 
ignite	点燃	 [ɪgˈnaɪt] 
jocular	爱开玩笑的	 [ˈdʒɒkjələ(r)] 
orchestrate	精心策划;把（乐曲）编成管弦乐	 [ˈɔ:kɪstreɪt]  
ineluctable	不可避免的	 [ˌɪnɪˈlʌktəbl] 
austere	简朴的;严厉的	 [ɒˈstɪə(r)] 
induct	使正式就任	 [ɪnˈdʌkt] 
impeccable	无缺点的	 [ɪmˈpekəbl] 
instil(l)	逐步灌输;使渗透	[ɪnˈstɪl] 
harmonize	使和谐	 [ˈhɑ:mənaɪz] 
undercut	从下削球;廉价出售;较便宜的工资工作;里脊	[ˌʌndəˈkʌt]
contemplate	深思熟虑	[ˈkɒntəmpleɪt]
corrode	使腐蚀	 [kəˈrəʊd] 
inundate	淹没;（洪水般的）扑来;使充满	 [ˈɪnʌndeɪt] 
infiltrate	（使）渗透	 [ˈɪnfɪltreɪt] 
inculcate	极力主张	 [ˈɪnkʌlkeɪt] 
injunction	强制令	 [ɪnˈdʒʌŋkʃn] 
mobilize	动员	 [ˈməʊbəlaɪz] 
infatuated	热恋的，着迷的	[ɪnˈfætʃueɪtɪd] 
paranoid	属于偏执狂的	 [ˈpærənɔɪd] 
reciprocate	回报;互换	 [rɪˈsɪprəkeɪt] 
frenetic	狂热的	 [frəˈnetɪk] 
cranky	古怪的	 [ˈkræŋki] 
beset	困扰;包围;镶	 [bɪˈset] 
feud	长期不和	[fju:d]
canny	精明的	 [ˈkæni] 
inadvertent	疏忽的	[ˌɪnəd'vɜ:tənt] 
rend	撕碎	 [rend] 
correspond	通信;符合	 [ˌkɒrəˈspɒnd] 
glare	强光;怒视	 [gleə(r)] 
immunize	使免疫	 [ˈɪmjunaɪz] 
aberrant	异常的	 [æˈberənt] 
slur	诽谤;含糊地说	[slɜ:(r)] 
judicious	明智的	 [dʒuˈdɪʃəs] 
vernacular	白话的，本国语的	 [vəˈnækjələ(r)] 
slink	偷偷溜走，早产	 [slɪŋk] 
skid	打滑，刹住，防滑的	 [skɪd] 
redemptive	救赎的	 [rɪˈdemptɪv] 
fickle	（爱情、友谊等）易变的	 [ˈfɪkl] 
unparalleled	空前的	 [ʌnˈpærəleld] 
forbear	（尤指为表示礼貌或耐心而）克制	 [fɔ:ˈbeə(r)] 
dissociate	使分离	 [dɪˈsəʊʃieɪt] 
invigorate	使生气勃勃	 [ɪnˈvɪgəreɪt] 
visualize	形成思维图像	 [ˈvɪʒuəlaɪz] 
intermittent	间歇的	 [ˌɪntəˈmɪtənt] 
subvert	破坏	 [səbˈvɜ:t] 
grievous	严重的;令人伤心或痛苦的;	 [ˈgri:vəs] 
palatable	可口的	 [ˈpælətəbl] 
quadruple	四倍	 [kwɒˈdru:pl]
notion	观念	 [ˈnəʊʃn] 
harebrained	轻率的	 ['heə'breɪnd] 
blare	巨响;光泽;高声宣布	 [bleə(r)] 
frenzied	狂暴的	 [ˈfrenzid] 
insulate	使隔离	 [ˈɪnsjuleɪt] 
twirl	旋转	 [twɜ:l]
status	地位，情形	 [ˈsteɪtəs] 
alleviate	减轻	 [əˈli:vieɪt] 
acquit	宣判无罪;表现	 [əˈkwɪt] 
foist	强迫接受	 [fɔɪst] 
ambience	周围环境;气氛	 [ˈæmbiəns] 
hermetic	密封的	 [hɜ:ˈmetɪk] 
amiable	和蔼可亲的	 [ˈeɪmiəbl]
brittle	易碎的;难以相处的;声音尖利的	 [ˈbrɪtl] 
incredulous	表示怀疑的	 [ɪnˈkredjələs]
magnanimous	宽宏大量的	 [mægˈnænɪməs]  
flair	天资;眼光	 [fleə(r)] 
heckle	梳理，诘问	[ˈhekl] 
neural	神经的	 [ˈnjʊərəl] 
ulterior	不可告人的	 [ʌlˈtɪəriə(r)]
bemoan	哀叹	 [bɪˈməʊn]
reserve	保留	 [rɪˈzɜ:v] 
wane	衰退，（月）亏	 [weɪn] 
fainthearted	懦弱的	 ['feɪnth'ɑ:tɪd]
didactic	（指人）学究式的	 [daɪˈdæktɪk] 
opaque	不透明，晦暗，含糊的	 [əʊˈpeɪk] 
fallacious	谬误的	 [fəˈleɪʃəs] 
lateral	侧面的	[ˈlætərəl]
shamble	蹒跚而行	 [ˈʃæmbl] 
estimable	值得尊敬的	 [ˈestɪməbl] 
outweigh	在重量上超过，比…重要	 [ˌaʊtˈweɪ] 
unwitting	未觉察的	 [ʌnˈwɪtɪŋ] 
attest	证实	 [əˈtest] 
hangover	宿醉，遗留的感觉（或风俗、习惯等），后遗症	 [ˈhæŋəʊvə(r)] 
presuppose	假设	 [ˌpri:səˈpəʊz] 
shrivel	（因热力，严寒、干燥、年老等而）枯萎	 [ˈʃrɪvl] 
ecstasy	狂喜;迷幻药	[ˈekstəsi] 
entangle	缠住	 [ɪnˈtæŋgl] 
gloat	幸灾乐祸	 [gləʊt] 
inanimate	无生气的	 [ɪnˈænɪmət] 
relinquish	放弃	 [rɪˈlɪŋkwɪʃ] 
underlie	位于或存在于（某物）之下;构成…的基础（或起因）	 [ˌʌndəˈlaɪ] 
embellish	装饰	 [ɪmˈbelɪʃ] 
efficacy	功效	[ˈefɪkəsi] 
indent	缩进;订单	 [ɪnˈdent]
gorge	峡谷，拚命吃	 [gɔ:dʒ] 
stuff	材料，现金，塞满，吃得过多	 [stʌf] 
infuriate	狂怒的	 [ɪnˈfjʊərieɪt]
swirl	旋转	 [swɜ:l] 
stricture	约束；指责	 [ˈstrɪktʃə(r)] 
commentate	评论	 [ˈkɒmənteɪt]
chaste	（性生活）忠于配偶的;（风格）简单的	 [tʃeɪst] 
revamp	将（某物）翻新	 [ˌri:ˈvæmp] 
digital	数字的	[ˈdɪdʒɪtl]
decency	正直	 [ˈdi:snsi] 
dishono(u)r	丢脸的事（或人）	 [dɪs'ɒnə]
spew	呕吐，喷出，渗出	 [spju:] 
evanescent	迅速消失遗忘的	 [ˌi:vəˈnesnt] 
smother	（使）窒息，浓烟	[ˈsmʌðə(r)] 
tedium	单调乏味	 [ˈti:diəm] 
digress	离题的	[daɪˈgres]
heterogeneous	各种各样的	[ˌhetərəˈdʒi:niəs] 
inmost	最深的	 [ˈɪnməʊst] 
horrific	令人恐惧的	 [həˈrɪfɪk] 
rampant	猖獗的;（指动物）只用后腿站立的;（植物）疯长的	 [ˈræmpənt] 
admonish	训诫	 [ədˈmɒnɪʃ] 
stamina	持久力	[ˈstæmɪnə] 
forthright	直率的	 [ˈfɔ:θraɪt] 
tangent	正切;突然转移话题;突兀的转向;	 [ˈtændʒənt] 
tact	机敏;[乐]拍子;触觉	[tækt]
nestle	满意地依偎或紧贴	 [ˈnesl] 
enfeeble	使衰弱	 [ɪnˈfi:bl]
abrasive	摩擦的，使人厌烦的	 [əˈbreɪsɪv] 
insinuate	暗示;（使）缓慢进入;	 [ɪnˈsɪnjueɪt] 
shove	推	[ʃʌv] 
freehand	徒手画（的）	[ˈfri:hænd] 
premonition	预兆	 [ˌpri:məˈnɪʃn] 
sap	坑道;树液;元气;使伤元气;挖坑道	 [sæp] 
leniency	仁慈	 ['li:nɪənsɪ] 
frolic	嬉戏	 [ˈfrɒlɪk] 
optimize	使最优化	 [ˈɒptɪmaɪz] 
enviable	值得羡慕的	 [ˈenviəbl] 
bequeath	将（财物等）遗赠给;将（知识等）传给（后人）	 [bɪˈkwi:ð] 
grind	磨	 [graɪnd] 
blanket	毛毯	 [ˈblæŋkɪt] 
mattress	床垫	[ˈmætrəs]
pillowcase	枕套	[ˈpɪləʊkeɪs]
closet	衣柜	[ˈklɒzɪt]
wardrobe	衣柜	 [ˈwɔ:drəʊb] 
vanity	虚荣	[ˈvænəti] 
bassinet	摇篮	 [ˌbæsɪˈnet] 
bunk	铺位	[bʌŋk] 
canopy	顶篷	 [ˈkænəpi] 
futon	蒲团	[ˈfu:tɒn]
hammock	吊床	[ˈhæmək] 
blinds	百叶窗	[blaɪndz] 
braid	辫子	 [breɪd] 
brush	刷子	[brʌʃ] 
pat	轻拍	[pæt]
powder	粉末	 [ˈpaʊdə(r)]
spray	喷	[spreɪ] 
blush	脸红	 [blʌʃ] 
compact	紧凑的,协议	 [kəmˈpækt]
eyelash	睫毛	 [ˈaɪlæʃ] 
curler	卷发的人	[ˈkɜ:lə(r)]
foundation	基础，粉底	[faʊnˈdeɪʃn]
lip	嘴唇	[lɪp]
balm	香油，安抚	 [bɑ:m]
lipstick	口红	[ˈlɪpstɪk]
mascara	睫毛膏	 [mæˈskɑ:rə] 
bobby pin	发夹	 [ˈbɔbi pin] 
clip	修剪	 [klɪp] 
mousse	定型摩丝	 [mu:s] 
gel	定型发胶	 [dʒel] 
moisturizer	润肤霜	[ˈmɔɪstʃəraɪzə(r)]
nail	指甲，钉子	 [neɪl] 
toner	爽肤水	 [ˈtəʊnə(r)]
tweezer	镊子	 ['twi:zə] 
breastfeed	母乳喂养	 [ˈbrestfi:d] 
crawl	爬行	 [krɔ:l]
toddle	蹒跚学步	[ˈtɒdl]
lotion	护肤液	 [ˈləʊʃn] 
bib	（小儿用的）围嘴	 [bɪb] 
diaper	尿布	 [ˈdaɪəpə(r)] 
doll	玩偶	[dɒl]
formula	公式	 [ˈfɔ:mjələ] 
pacifier	奶嘴	[ˈpæsɪfaɪə(r)]
booster	助推器	[ˈbu:stə(r)]
crib	婴儿床	 [krɪb] 
playpen	（供幼儿在内玩耍的）护栏	[ˈpleɪpen] 
potty	便壶，琐碎的	 [ˈpɒti] 
asthma	哮喘	[ˈæsmə]
colic	绞痛，疝痛	 [ˈkɒlɪk]
chickenpox	水痘	[ˈtʃɪkɪnpɒks] 
rash	皮疹，鲁莽的	 [ræʃ]
diarrhea	腹泻	 [ˌdaɪə'rɪə] 
allergy	过敏性反应	 [ˈælədʒi] 
jaundice	黄疸	[ˈdʒɔ:ndɪs]
measles	麻疹	[ˈmi:zlz] 
jot	匆忙记下，一点	[dʒɒt] 
staple	用钉书钉钉住，主要部份	[ˈsteɪpl]
glue	胶水	 [glu:]
scissors	剪刀	 [ˈsɪzəz]
utility	功用	 [ju:ˈtɪləti]
pitch 	抛	 [pɪtʃ] 
iron	坚强的，铁，熨斗	 [ˈaɪən] 
wrinkle	使起皱纹，窍门	[ˈrɪŋkl] 
zip	拉链，尖啸而过	 [zɪp] 
blouse	女衬衫，使…宽松下垂	 [blaʊz] 
skirt	裙子，位于…的边缘	 [skɜ:t] 
suspender	悬挂物，吊裤带	 [səˈspendə(r)] 
sweater	毛衣，运动衫	[ˈswetə(r)] 
tank top	油罐顶盖，背心装	
bracelet	手镯，手铐	 [ˈbreɪslət] 
hanger	衣架，挂钩	 [ˈhæŋə(r)]
mothball	樟脑球，后备的	 [ˈmɒθbɔ:l] 
panty	童裤，女裤	 ['pæntɪ] 
sock	短袜，（尤指用拳头）猛击	 [sɒk]
bleach	漂白	 [bli:tʃ] 
dilute	稀释	 [daɪˈlu:t] 
screw	螺旋状物，（和某人）性交	 [skru:] 
soak	浸泡	 [səʊk]
sling	吊索，鞋带，投掷，遣送	[slɪŋ]
detergent	洗涤剂	[dɪˈtɜ:dʒənt] 
fabric	织物，质地	[ˈfæbrɪk]
laundry	洗衣	 [ˈlɔ:ndri]
tub	把…装入桶，为…洗盆浴	 [tʌb] 
lid	给…盖盖子	 [lɪd] 
cylinder	（尤指用作容器的）圆筒状物	 [ˈsɪlɪndə(r)] 
balustrade	（阳台的）栏杆	 [ˌbæləˈstreɪd] 
chaise	（供一人或两人乘坐的）轻便马车	 [ʃeɪz] 
tongue	舌头，吹奏（管乐器）	 [tʌŋ] 
fence	栅栏，剑术	 [fens] 
seeder	播种人	 ['si:də]
chime	敲出和谐的乐声	 [tʃaɪm]
harmonious	和谐的	 [hɑ:ˈməʊniəs] 
stamp	邮票，用脚踩踏	 [stæmp] 
buzzer	蜂鸣器	 [ˈbʌzə(r)] 
deodorizer	除臭剂	[di:'əʊdəraɪzə]
intercom	内部通话系统	 [ˈɪntəkɒm] 
couplet	对联	 [ˈkʌplət] 
vase	花瓶	 [vɑ:z] 
sneakers	运动鞋	 ['sni:kəz]
shoehorn	鞋拔	 [ˈʃu:hɔ:n] 
bolt	门闩	[bəʊlt]
knob	球形把手	 [nɒb] 
pee	小便	[pi:] 
peephole	窥视孔	[ˈpi:phəʊl] 
floss	丝棉，用牙线清洁牙齿	 [flɒs] 
shave	剃须	 [ʃeɪv] 
spit	吐口水，烤肉叉	 [spɪt]
shampoo	洗发剂	 [ʃæmˈpu:] 
scale	规模，攀登，刮去…的鳞片	 [skeɪl] 
faucet	水龙头	 [ˈfɔ:sɪt] 
razor	剃须	[ˈreɪzə(r)] 
assemble	集合	 [əˈsembl] 
bend	（使）弯曲	 [bend] 
measure	测量	 [ˈmeʒə(r)]
saw	锯，看，谚语	[sɔ:] 
broom	扫帚	 [bru:m] 
dustpan	簸箕	 [ˈdʌstpæn] 
feather	羽毛	[ˈfeðə(r)] 
plier	钳子，镊子	 ['plaɪə] 
wrench	扳手，扭伤	 [rentʃ] 
carpenter	木匠	 [ˈkɑ:pəntə(r)] 
locksmith	锁匠	 [ˈlɒksmɪθ]
plumber	水暖工	[ˈplʌmə(r)] 
ammonia	氨，氨水，氨气	 [əˈməʊniə]
disinfectant	消毒剂	 [ˌdɪsɪnˈfektənt] 
wax	蜡	 [wæks] 
chandelier	吊灯	 [ˌʃændəˈlɪə(r)] 
lounge	客厅，懒洋洋地躺	 [laʊndʒ] 
revolve	使旋转，反复考虑，使循环	[rɪˈvɒlv] 
abandoned	被放弃的，热情洋溢的	[əˈbændənd] 
recreational	娱乐的	[ˌrekriˈeɪʃənl] 
solicitor	初级律师，求婚者	[səˈlɪsɪtə(r)]
malfunction	发生故障	[ˌmælˈfʌŋkʃn] 
suffocate	窒息	[ˈsʌfəkeɪt] 
lantern	灯笼	 [ˈlæntən] 
shaft	柄	[ʃɑ:ft]
gym	体育馆	 [dʒɪm] 
aerobics	有氧运动	 [eəˈrəʊbɪks] 
treadmill	（锻炼身体的）跑步机	 [ˈtredmɪl] 
resident	常驻的	 [ˈrezɪdənt] 
superintendent	主管	 [ˌsu:pərɪnˈtendənt] 
gross	总的，恶劣的	[grəʊs] 
spacious	宽敞的，（知识）广博的	 [ˈspeɪʃəs] 
spiral	螺旋形的	[ˈspaɪrəl] 
landlord	房东	[ˈlændlɔ:d] 
stray	走失的，（已婚者或有固定关系者）有外遇 	[streɪ] 
tenant	房客	 [ˈtenənt]
bale	将某物打成包或包装成捆，灾害	 [beɪl] 
contaminate	污染	 [kənˈtæmɪneɪt] 
haul	拖	 [hɔ:l] 
stink	散发出恶臭	 [stɪŋk]
flammable	易燃的	[ˈflæməbl]
chute	斜槽	[ʃu:t]
landfill	废渣埋填法	 [ˈlændfɪl] 
odor	气味，名声	 ['əʊdə] 
vermin	害虫	 [ˈvɜ:mɪn] 
garage	车库，汽车修理站	 [ˈgærɑ:ʒ]
metal	金属	[ˈmetl]
textile	纺织品	[ˈtekstaɪl] 
clamp	夹紧，堆高	 [klæmp] 
dismantle	拆卸	 [dɪsˈmæntl] 
renovate	翻新	 [ˈrenəveɪt] 
rust	生锈	 [rʌst] 
billboard	广告牌	 [ˈbɪlbɔ:d] 
corrugate	（使某物）起皱褶，沟	['kɒrʊgeɪt]
ladder	梯子，使（袜子）发生抽丝现象	[ˈlædə(r)] 
lightning	闪电	 [ˈlaɪtnɪŋ] 
ventilating	通风，公开	 ['ventɪleɪtɪŋ] 
proof	证明，检验，防…的	[pru:f] 
inhabitant	居民	 [ɪnˈhæbɪtənt] 
stubborn	顽固的	 [ˈstʌbən] 
bloom	开花，最盛期	 [blu:m] 
fertilize	施肥，使受孕	 [ˈfɜ:təlaɪz] 
mow	割，干草堆，鬼脸	[məʊ] 
prune	剪去，西梅脯	 [pru:n] 
weed	给…除杂草，大麻	 [wi:d] 
grill	烤架	 [grɪl] 
hedge	树篱	 [hedʒ] 
lawn	草坪	 [lɔ:n] 
porch	走廊	[pɔ:tʃ] 
patio	院子，露台	[ˈpætiəʊ] 
pergola	藤架	 [ˈpɜ:gələ] 
handyman	受雇做杂事的人	 [ˈhændimæn] 
gable	尖顶屋两端的山形墙	 [ˈgeɪbl]
ridge	 [rɪdʒ] 	 [rɪdʒ] 
flat	平的，公寓，不景气的	 [flæt] 
sill	门槛，窗台（板）	 [sɪl]
corrugated	波纹的	 [ˈkɒrəgeɪtɪd]
terracotta	陶瓦，赤褐色	 [ˌterəˈkɒtə]
thatch	茅草屋顶	 [θætʃ] 
timber	木材	 [ˈtɪmbə(r)] 
chimney	烟囱，壁炉	 [ˈtʃɪmni] 
boast	自夸	 [bəʊst]
furnish	装修（房屋）	[ˈfɜ:nɪʃ] 
antique	古董的	 [ænˈti:k] 
fountain	泉源	[ˈfaʊntən] 
jacuzzi	按摩浴缸	
salon	沙龙，客厅	 [ˈsælɒn]
tapestry	挂毯	[ˈtæpəstri] 
carousal	狂欢	 [kə'raʊzəl] 
feast	宴会	 [fi:st] 
costume party	化装舞会	
butler	男管家	[ˈbʌtlə(r)]
celebrity	名流	 [səˈlebrəti] 
servant	仆人	[ˈsɜ:vənt] 
tycoon	大亨	 [taɪˈku:n]
demolish	拆毁	 [dɪˈmɒlɪʃ] 
erect	使竖起	 [ɪˈrekt]
reside	居住	[rɪˈzaɪd] 
suburbanize	使成[变]为市郊	[sə'bɜ:bənaɪz] 
urbanize	使都市化	 ['ɜ:bənaɪz] 
dome	圆屋顶	 [dəʊm] 
planetarium	天文馆	 [ˌplænɪˈteəriəm] 
metropolis	大都市	 [məˈtrɒpəlɪs] 
suburb	郊区	 [ˈsʌbɜ:b]
asymmetric	不对称的	[ˌeɪsɪˈmetrɪk] 
baroque	巴罗克风格，奇形怪状的	 [bəˈrəʊk] 
geometric	几何学的	[ˌdʒi:əˈmetrɪk] 
magnificent	壮丽的	 [mægˈnɪfɪsnt] 
transparent	透明的	 [trænsˈpærənt] 
appeal	上诉，（迫切）要求，有吸引力	 [əˈpi:l] 
consume	消耗	 [kənˈsju:m]
promote	促进，促销	 [prəˈməʊt] 
boutique	精品店	 [bu:ˈti:k] 
cybercafe	网吧	 [ˈsaɪbəkæfeɪ] 
florist	花农	[ˈflɒrɪst] 
furniture	家具	 [ˈfɜ:nɪtʃə(r)]
grocery	食品杂货店	 [ˈgrəʊsəri] 
jewelry	珠宝	 ['dʒu:əlrɪ] 
laundromat	自助洗衣店	 ['lɔ:ndrəmæt] 
pharmacy	药学	 [ˈfɑ:məsi]
flagship	旗舰	 [ˈflægʃɪp] 
pickpocket	扒手	 [ˈpɪkpɒkɪt] 
protest	抗议	 [ˈprəʊtest]
scatter	分散	 [ˈskætə(r)] 
surround	围绕	 [səˈraʊnd] 
hydrant	消防龙头	 [ˈhaɪdrənt] 
gazebo	凉亭	 [gəˈzi:bəʊ] 
lamppost	路灯柱	 ['læmppəʊst] 
statue	雕像	 [ˈstætʃu:] 
countdown	倒计时	 [ˈkaʊntdaʊn] 
flea	跳蚤	 [fli:] 
hunger strike	表示抗议的绝食	 [ˈhʌŋɡə straik] 
strike	攻击，罢（工、课等）	 [straɪk] 
parade	游行	 [pəˈreɪd]
ban	禁止	 [bæn] 
drip	（使）滴下	 [drɪp] 
pile	堆叠	 [paɪl]
stall	货摊，（房间内的）小隔间，拖延	 [stɔ:l] 
cobbler	修鞋匠，胡说	 [ˈkɒblə(r)] 
bidet	坐浴盆	[ˈbi:deɪ]
squat	蹲	[skwɒt]
urinal	小便池	[jʊəˈraɪnl] 
addict	有瘾的人	 [ˈædɪkt] 
compost	堆肥，合成	 [ˈkɒmpɒst] 
cultivate	耕作	 [ˈkʌltɪveɪt] 
harvest	收割	 [ˈhɑ:vɪst] 
irrigate	灌溉	[ˈɪrɪgeɪt] 
plow	犁	 [plaʊ] 
sow	播（种），激起，母猪	 [səʊ]
barn	粮仓，（公共汽车、卡车等的）车库	 [bɑ:n] 
insecticide	杀虫剂	 [ɪnˈsektɪsaɪd]
shed	棚，分水岭，流出，蜕皮	 [ʃed]
hoe	用锄除（草等）	 [həʊ] 
barley	大麦	 [ˈbɑ:li] 
millet	小米，粟	 [ˈmɪlɪt] 
oat	燕麦	 [əʊt] 
rye	黑麦	 [raɪ] 
wheat	小麦	 [wi:t] 
cultivator	耕种者	 [ˈkʌltɪveɪtə(r)] 
expropriation	征用	 [ˌeksˌprəʊprɪ'eɪʃn] 
sharecropper	佃农	[ˈʃeəkrɒpə(r)] 
brew	酿造	[bru:]
ventilate	通风，公开	 [ˈventɪleɪt]
crate	装货箱	 [kreɪt] 
greenhouse	温室	[ˈgri:nhaʊs] 
pesticide	杀虫剂，农药	 [ˈpestɪsaɪd] 
shovel	铲	 [ˈʃʌvl]
shrub	灌木丛，果汁甜酒	 [ʃrʌb] 
vineyard	葡萄园，工作场所	[ˈvɪnjəd]
oak	橡木	[əʊk]
winery	葡萄酒酿造厂	 [ˈwaɪnəri] 
fig	无花果	 [fɪg] 
orchardist	果树栽培者	 ['ɔ:tʃədɪst] 
breed	产（后代），养育，种类	 [bri:d] 
graze	放牧，擦过	 [greɪz] 
herd	牧群	 [hɜ:d]
barrel	桶，高速行驶	 [ˈbærəl] 
hay	干草	 [heɪ] 
tent	帐篷，塞子，看护	[tent] 
ranch	大牧场	 [rɑ:ntʃ]
stable	稳定的，马厩	 [ˈsteɪbl] 
trough	水槽	 [trɒf] 
barrow	独轮车	 [ˈbærəʊ] 
yak	牦牛，笑话，唠叨	 [jæk] 
poultry	家禽	 [ˈpəʊltri] 
goose	鹅，傻瓜	 [gu:s]
cowherd	牧牛者	['kaʊhɜ:d]
grazier	放牧人	 [ˈgreɪziə(r)] 
nomad	流浪者，游牧民	 [ˈnəʊmæd] 
rancher	大牧场主	 [ˈrɑ:ntʃə(r)] 
bomb	炸弹;彻底的失败	 [bɒm] 
dismiss	解雇，解散（队伍等），拒绝受理	 [dɪsˈmɪs]
chalk	粉笔	[tʃɔ:k] 
silk	丝	 [sɪlk]
quiz	盘问，小型考试，恶作剧	 [kwɪz] 
intern	实习生，拘禁（俘虏等）	 [ɪnˈtɜ:n]
substitute	代替	 [ˈsʌbstɪtju:t] 
diameter	直径	 [daɪˈæmɪtə(r)] 
cone	圆锥形东西	 [kəʊn]
diamond	菱形，钻石	 [ˈdaɪəmənd] 
oval	椭圆形	 [ˈəʊvl] 
parallelogram	平行四边形	 [ˌpærəˈleləgræm] 
sector	部门，扇形	 [ˈsektə(r)] 
square	平方;广场;正方形	 [skweə(r)] 
trapezoid	梯形	 [ˈtræpəzɔɪd] 
triangle	三角形	 [ˈtraɪæŋgl]
addition	加，附加	 [əˈdɪʃn] 
algebra	代数	 [ˈældʒɪbrə] 
arithmetic	算术	 [əˈrɪθmətɪk] 
calculus	结石，微积分	 [ˈkælkjələs] 
division	分开，除法	 [dɪˈvɪʒn]
fraction	分数，一小部分	 [ˈfrækʃn]
geometry	几何学	 [dʒiˈɒmətri]
multiplication	乘法	 [ˌmʌltɪplɪˈkeɪʃn] 
subtraction	减法	 [səb'trækʃn] 
trigonometry	三角学	[ˌtrɪgəˈnɒmətri] 
abacus	算盘	 [ˈæbəkəs] 
graph	图表	 [græf] 
protractor	量角器	 [prəˈtræktə(r)]
minus	减	[ˈmaɪnəs] 
multiply	乘，多样的	[ˈmʌltɪplaɪ] 
draft	草稿	 [drɑ:ft]
plagiarize	抄袭	 [ˈpleɪdʒəraɪz] 
punctuate	加标点符号，不时打断，强调	 [ˈpʌŋktʃueɪt] 
revise	修订	 [rɪˈvaɪz] 
scribble	乱写	[ˈskrɪbl] 
digression	离题	 [daɪ'ɡreʃn] 
metaphor	隐喻	 [ˈmetəfə(r)]
climax	顶点	 [ˈklaɪmæks] 
simile	明喻	 [ˈsɪməli] 
essay	散文，尝试	 [ˈeseɪ]
prose	散文，枯燥无味的话	 [prəʊz] 
adjective	形容词	 [ˈædʒɪktɪv] 
adverb	副词	 [ˈædvɜ:b] 
noun	名词	 [naʊn] 
thesis	论文	 [ˈθi:sɪs] 
colon	冒号	 [ˈkəʊlən]
comma	逗号	 [ˈkɒmə]
hyphen	连字符	 [ˈhaɪfn] 
parenthesis	圆括号，插入语	 [pəˈrenθəsɪs] 
period	时期，句号	 [ˈpɪəriəd] 
tint	染色	 [tɪnt] 
composition	创作，妥协	 [ˌkɒmpəˈzɪʃn] 
hue	色调，外表	 [hju:]
plaster	黏贴，石膏，涂墙泥	 [ˈplɑ:stə(r)] 
portrait	肖像	[ˈpɔ:treɪt] 
technique	技术	 [tekˈni:k]
texture	质地，结构	 [ˈtekstʃə(r)] 
charcoal	木炭，炭画笔	 [ˈtʃɑ:kəʊl]
easel	画架	 [ˈi:zl] 
palette	调色板	 [ˈpælət] 
coral	珊瑚	 [ˈkɒrəl] 
pluck	勇气，快而猛的拉，内脏	 [plʌk]
tune	曲调	 [tju:n] 
notation	记号	 [nəʊˈteɪʃn]
bass	低音的	 [beɪs] 
treble	高音的，三倍的	[ˈtrebl]
tempo	节奏	 [ˈtempəʊ] 
elegant	优美的，简炼的	 [ˈelɪgənt] 
hoarse	嘶哑的	 [hɔ:s] 
castanet	响板	 [ˌkæstə'net] 
flute	长笛	 [flu:t]
harmonica	口琴	 [hɑ:ˈmɒnɪkə] 
recorder	录音机;直笛	 [rɪˈkɔ:də(r)]
tambourine	手鼓	 [ˌtæmbəˈri:n] 
xylophone	木琴	[ˈzaɪləfəʊn]
experiment	实验	 [ɪkˈsperɪmənt] 
heat	使热	 [hi:t]
induce	引起	 [ɪnˈdju:s] 
observe	观察	 [əbˈzɜ:v] 
astronomical	天文学的，极大的	 [ˌæstrəˈnɒmɪkl]
beaker	烧杯	 [ˈbi:kə(r)] 
funnel	漏斗	 [ˈfʌnl] 
magnify	放大	 [ˈmægnɪfaɪ] 
tweezers	镊子	 [ˈtwi:zəz] 
astronomy	天文学	 [əˈstrɒnəmi] 
ecology	生态学	 [iˈkɒlədʒi] 
genetics	遗传学	 [dʒəˈnetɪks] 
zoology	动物学	 [zəʊˈɒlədʒi] 
anode	阳极	 [ˈænəʊd] 
cathode	阴极	 [ˈkæθəʊd] 
photosynthesis	光合作用	 [ˌfəʊtəʊˈsɪnθəsɪs]
interact	互动	 [ˌɪntərˈækt] 
publicize	宣传	 [ˈpʌblɪsaɪz] 
socialize	（与…）交往	[ˈsəʊʃəlaɪz] 
alumni	校友	alumni
chorus	合唱	 [ˈkɔ:rəs] 
drama	戏剧	 [ˈdrɑ:mə] 
orchestra	管弦乐队	 [ˈɔ:kɪstrə] 
photography	摄影	 [fəˈtɒgrəfi] 
scout	童子军;侦察员	 [skaʊt] 
farewell	告别	 [ˌfeəˈwel] 
orientation	方向，任职培训	[ˌɔ:riənˈteɪʃn] 
publicity	宣传	 [pʌbˈlɪsəti] 
buff	缓冲，黄褐色软皮革	[bʌf] 
enroll	注册	 [ɪn'rəʊl] 
expel	驱逐	 [ɪkˈspel] 
lecture	演讲，教训	 [ˈlektʃə(r)] 
minor	较小的，少数的，选修	 [ˈmaɪnə(r)] 
credit	学分，信用	 [ˈkredɪt] 
syllabus	（讲义等的）摘要	 [ˈsɪləbəs] 
transfer	使转移	 [trænsˈfɜ:(r)] 
tuition	学费;教学	 [tjuˈɪʃn] 
academic	学院的，文科的，学者	 [ˌækəˈdemɪk] 
commencement	开始;毕业典礼	 [kəˈmensmənt] 
diploma	毕业文凭	 [dɪˈpləʊmə]
assistant professor 	助理教授（级别高于讲师而低于副教授）	 [əˈsistənt prəˈfesə] 
associate professor 	副教授	[əˈsəuʃieit prəˈfesə] 
freshman	大一	 [ˈfreʃmən] 
sophomore	大二	 [ˈsɒfəmɔ:(r)] 
junior	大三	 [ˈdʒu:niə(r)] 
senior	大四	 [ˈsi:niə(r)] 
salute	敬礼	 [səˈlu:t] 
chin	下巴，聊天，作引体向上动作	 [tʃɪn] 
dodge	闪躲	 [dɒdʒ] 
jungle	丛林，尔虞我诈的环境	 [ˈdʒʌŋgl] 
hurdle	障碍	 [ˈhɜ:dl] 
vault	拱顶	 [vɔ:lt] 
relay	接替，转播	 [ˈri:leɪ] 
track	轨道，追踪	 [træk] 
distribute	分发;把…分类	 [dɪˈstrɪbju:t] 
negotiate	协商	[nɪˈgəʊʃieɪt] 
discipline	训练;使有纪律;	[ˈdɪsəplɪn] 
auditorium	观众席，礼堂	 [ˌɔ:dɪˈtɔ:riəm] 
cafeteria	自助餐厅	 [ˌkæfəˈtɪəriə]
counselor	指导老师	 ['kaʊnsələ] 
puke	呕吐	 [pju:k] 
aspirin	阿司匹林	 [ˈæsprɪn] 
crutch	拐杖;支持物	 [krʌtʃ]
gauze	纱布	 [gɔ:z] 
hydrogen peroxide 	过氧化氢	 [ˈhaidrədʒən pəˈrɔkˌsaɪd] 
iodine	碘	 [ˈaɪədi:n] 
painkiller	止痛药	 [ˈpeɪnkɪlə(r)] 
stethoscope	听诊器	[ˈsteθəskəʊp] 
stretcher	担架	 [ˈstretʃə(r)] 
thermometer	温度计	[θəˈmɒmɪtə(r)] 
acuity	敏锐度	 [əˈkju:əti] 
abrasion	擦伤处	[əˈbreɪʒn] 
dysmenorrhea	痛经	[ˌdɪsmenəʊ'ri:ə]
sprain	扭伤	 [spreɪn] 
ophthalmologist	眼科专家	 [ˌɒfθælˈmɒlədʒɪst] 
sneak	溜走，小偷，告密的人	 [sni:k] 
supervise	监督	[ˈsu:pəvaɪz]
dump	倾倒，垃圾场	 [dʌmp]
courtesy	有礼貌的举止	 [ˈkɜ:təsi] 
curfew	宵禁	[ˈkɜ:fju:] 
hygiene	卫生	 [ˈhaɪdʒi:n] 
burglar	窃贼	 [ˈbɜ:glə(r)] 
owl	猫头鹰，夜猫子，机警的人	 [aʊl]
nuisance	讨厌的东西（人，行为）	 [ˈnju:sns] 
peep	窥视;唧唧声	 [pi:p] 
acquaintance	熟人	 [əˈkweɪntəns] 
bid	出价，力求	 [bɪd]
crayon	彩色蜡笔或粉笔	[ˈkreɪən] 
cubby	小房间	 ['kʌbɪ] 
handkerchief	手帕	 [ˈhæŋkətʃɪf] 
pin	别针	 [pɪn] 
seesaw	跷跷板	 ['si:sɔ:] 
swing	摇摆	 [swɪŋ] 
hopscotch	跳房子	 [ˈhɒpskɒtʃ] 
cram	塞满;死记硬背	 [kræm] 
elaborate	详尽说明，精心制作的	 [ɪˈlæbərət] 
motivate	激励	[ˈməʊtɪveɪt] 
puzzle	伤脑筋	[ˈpʌzl]
resit	补考	[ˌri:ˈsɪt] 
conform	遵照	 [kənˈfɔ:m]
frustrate	使受挫折	[frʌˈstreɪt] 
slam	砰然关上	 [slæm] 
maneuver	演习，策略，操纵	 [mə'nu:və] 
surpass	超过	 [səˈpɑ:s] 
steer	驾驶	 [stɪə(r)] 
invigilator	监视器，监考人	[ɪn'vɪdʒɪleɪtə(r)] 
collaborate	合作	 [kəˈlæbəreɪt] 
lay	放置，产卵，外行的	[leɪ] 
quibble	推脱	 [ˈkwɪbl]
cubicle	小卧室	 [ˈkju:bɪkl] 
partition	分割	[pɑ:ˈtɪʃn] 
fax	传真	 [fæks] 
kitchenette	小厨房	 [ˌkɪtʃɪˈnet] 
photocopier	复印机	 [ˈfəʊtəʊkɒpiə(r)] 
convention	惯例;会议;全体与会者	
conventional 	传统的	 [kənˈvenʃənl] 
perforate	穿孔于	 [ˈpɜ:fəreɪt] 
seal	密封，盖章，海豹	 [si:l] 
memo	备忘录，内部通知	[ˈmeməʊ] 
stapler	订书机，主要产品经营商	 [ˈsteɪplə(r)] 
thumbtack	图钉	 [ˈθʌmtæk]
neat	整洁的	 [ni:t] 
cartridge	子弹，笔芯，墨盒	 [ˈkɑ:trɪdʒ] 
commence	开始，获得学位	 [kəˈmens] 
conceive	怀孕;构思	[kənˈsi:v] 
conclude	得出结论	 [kənˈklu:d] 
rehearse	排练，详述	[rɪˈhɜ:s] 
projector	投影仪;放映机	[prəˈdʒektə(r)]
transparency	透明度	[trænsˈpærənsi] 
soundproof	隔音的	 [ˈsaʊndpru:f] 
manufacture	制造	 [ˌmænjuˈfæktʃə(r)] 
telecommuter	远程办公人员	 [ˌtelɪkə'mju:tə(r)] 
standardize	使标准化	 [ˈstændədaɪz]
canteen	小卖部，食堂，水罐，餐具盒	 [kænˈti:n] 
forklift	叉车	 ['fɔ:klɪft] 
lever	杠杆	 [ˈli:və(r)] 
latex	胶乳，（尤指橡胶树的）橡浆	 [ˈleɪteks] 
respirator	口罩，防毒面具	 [ˈrespəreɪtə(r)] 
visor	面颊，帽舌，盔甲，遮护	 [ˈvaɪzə(r)] 
foreman	工头	 [ˈfɔ:mən] 
supervisor	监督者	 [ˈsu:pəvaɪzə(r)] 
bury	埋葬，心致志于	 [ˈberi] 
weld	焊接	 [weld] 
backhoe	反铲挖土机	[ˈbækhəʊ] 
bulldozer	推土机;恐吓者	 [ˈbʊldəʊzə(r)] 
pneumatic	充气的	 [nju:ˈmætɪk] 
scaffold	脚手架，断头台	 [ˈskæfəʊld]
ceramic	陶瓷的	 [səˈræmɪk] 
plywood	胶合板	 [ˈplaɪwʊd] 
reinforce	加固，增援	 [ˌri:ɪnˈfɔ:s] 
shingle	鹅卵石;木瓦板;	 [ˈʃɪŋgl] 
contractor	订约人，承包人	 [kənˈtræktə(r)] 
ergonomics	人类工程学	 [ˌɜ:gəˈnɒmɪks] 
stream	河流，趋势，一连串，飘扬，按能力分班（或分组）	 [stri:m] 
tone	声调，色调，使更健壮	 [təʊn] 
upholstery	室内装饰品	 [ʌpˈhəʊlstəri] 
aesthetic	审美的	 [i:sˈθetɪk]
retail	零售	 [ˈri:teɪl] 
glazier	装玻璃的工人	 [ˈgleɪziə(r)] 
teleprompter	讲词提示器	 [ˈteliprɒmptə(r)] 
rundown	纲要;（尤指商业）削减;解释;	 [ˈrʌndaʊn] 
prop	道具，支持者	 [prɒps] 
variety	多样;种类;杂耍;变化	 [vəˈraɪəti] 
variety show	综艺节目	
boom	发出隆隆声;快速发展	 [bu:m] 
expose	揭露	[ɪk'spəʊz] 
rewind	重绕;倒回（影片、录音带等）	 [ˌri:ˈwaɪnd] 
shutter	快门;百叶窗，关闭	 [ˈʃʌtə(r)] 
diffuser	扩散器;散布者	 [dɪˈfju:zə(r)] 
reflect	反射，考虑，表达	 [rɪˈflekt] 
tripod	三脚架	 [ˈtraɪpɒd] 
campaign	运动;战役;竞选运动	 [kæmˈpeɪn]
stylist	发型师	 [ˈstaɪlɪst] 
manipulate	操纵，推拿	 [məˈnɪpjuleɪt] 
remix	使再混合	 [ˌri:ˈmɪks] 
scold	责骂	 [skəʊld] 
tape	录音，卷尺，胶带	 [teɪp] 
synthesizer	合成器	 [ˈsɪnθəsaɪzə(r)] 
equalizer	追平比分的得分，均衡器	 [ˈi:kwəlaɪzər]
compressor	压缩机	 [kəmˈpresə(r)] 
amplifier	放大器;扩音器;	 [ˈæmplɪfaɪə(r)] 
chord	弦，和谐一致	 [kɔ:d] 
harmony	和谐，一致，和声	 [ˈhɑ:məni] 
verse	韵文;使熟练或者精通	 [vɜ:s] 
vocalist	歌手	 [ˈvəʊkəlɪst] 
dub	封…为爵士;授予称号;配音;笨蛋;鼓声	 [dʌb] 
screenplay	剧本	[ˈskri:npleɪ]
remuneration	酬金	 [rɪˌmju:nəˈreɪʃn] 
dolly	玩具娃娃，手推车，移动摄影车	 [ˈdɒli] 
costume	服装，泳装	 [ˈkɒstju:m] 
montage	蒙太奇;（电影、电视的）镜头组接	 [ˌmɒnˈtɑ:ʒ] 
cinematographer	电影摄影技师	 [ˌsɪnəmə'tɒɡrəfə(r)] 
circulate	（使）循环;（使）流通;（使）流传	[ˈsɜ:kjəleɪt] 
obituary	讣告	 [əˈbɪtʃuəri] 
horoscope	星象;	 [ˈhɒrəskəʊp] 
coupon	优惠券，试样，配给券	 [ˈku:pɒn] 
caricature	漫画，讽刺画;	 [ˈkærɪkətʃʊə(r)] 
supplement	补充，副刊	 [ˈsʌplɪmənt] 
paparazzi	狗仔队	 [ˌpæpə'rætsɪ] 
columnist	专栏作家	 [ˈkɒləmnɪst] 
founder	倒塌，沉没，创始人	 [ˈfaʊndə(r)] 
journalist	新闻工作者	 [ˈdʒɜ:nəlɪst]
sponsor	发起者，赞助	 [ˈspɒnsə(r)] 
centerfold	（杂志的）中间插页	 ['sentəˌfəʊld] 
coverage	规模;保险项目;（新闻）报导	 [ˈkʌvərɪdʒ] 
criticism	批评，审定	 [ˈkrɪtɪsɪzəm] 
literary	文学（上）的	 [ˈlɪtərəri]  
pornographic	色情的	[ˌpɔ:nəˈgræfɪk] 
assess	估价	[əˈses] 
commission	委员会，手续费，委任	 [kəˈmɪʃn] 
proofread	校对	 ['pru:fri:d] 
typeset	排字，把书稿输入计算机	 ['taɪpset]
contract	签合同;缩小;感染	 [ˈkɒntrækt] 
copyright	版权	 [ˈkɒpiraɪt] 
royalty	版税;王权;庄严	 [ˈrɔɪəlti] 
illustration	插图;说明	 [ˌɪləˈstreɪʃn] 
typography	凸版印刷术	[taɪˈpɒgrəfi] 
manuscript	手稿	 [ˈmænjuskrɪpt] 
contributor	贡献者	 [kənˈtrɪbjətə(r)] 
illustrator	插图画家	 [ˈɪləstreɪtə(r)] 
proofreader	校对者	 ['pru:fri:də(r)] 
publicist	宣传人员;时事评论员	 [ˈpʌblɪsɪst] 
miscount	计算错误	[ˌmɪsˈkaʊnt] 
scanner	扫描器	 [ˈskænə(r)] 
sensor	传感器	 [ˈsensə(r)] 
courier	导游;通讯员	 [ˈkʊriə(r)] 
junkie	吸毒者;<口>爱好者;	 [ˈdʒʌŋki] 
delicatessen	熟食店	 [ˌdelɪkəˈtesn] 
counter	对立面;计数器;柜台;（某些棋盘游戏的）筹码	 [ˈkaʊntə(r)]
straw	稻草;吸管;毫无价值的东西;假的	 [strɔ:] 
grab	抓住	 [græb] 
carton	硬纸盒	[ˈkɑ:tn]
pantry	食品储存室;〈美俚〉胃	[ˈpæntri] 
measuring jug	量杯	
scoop	舀	 [sku:p] 
grocer	杂货商;食品商	 [ˈgrəʊsə(r)] 
canned	罐装的;录音的;喝醉了的	 [kænd]
rope	粗绳;一串;学会决窍	 [rəʊp] 
gargle	漱口	[ˈgɑ:gl]
feminine	有女性气质的;[语]阴性的	 [ˈfemənɪn] 
oral	口服的;口头的	 [ˈɔ:rəl] 
dental	牙齿的	 [ˈdentl] 
acid	酸的;尖刻的	 [ˈæsɪd] 
alkaline	碱的	[ˈælkəlaɪn] 
neutral	中立的;（化学中）中性的;（汽车或其他机器的）空挡位置	 [ˈnju:trəl] 
thoroughly	彻底地	 [ˈθʌrəli] 
conditioner	调节器	 [kənˈdɪʃənə(r)] 
dip	浸;浏览;（轻度或暂时地）减少;把（汽车前灯）的远光调为近光;	 [dɪp] 
pasta	意大利面食	 [ˈpæstə] 
lasagna	烤宽面条	 [lə'zɑ:njə] 
linguini	（意大利）扁面条	 ['lɪngwɪnɪ] 
macaroni	意大利粉，通心面	 [ˌmækəˈrəʊni] 
pickle	腌渍（泡菜等）;遇到麻烦	 [ˈpɪkl] 
snack	快餐	 [snæk] 
crisp	脆的	 [krɪsp]
calorie	卡路里	 [ˈkæləri] 
salty	咸的	 [ˈsɔ:lti] 
condiment	调味品	 [ˈkɒndɪmənt] 
bouillon	牛肉汤	 ['bu:jɒn] 
dressing	穿衣;调味品;肥料	 [ˈdresɪŋ] 
vinegar	醋;尖酸刻薄;	 [ˈvɪnɪgə(r)] 
mist	（使）蒙上薄雾;（使）模糊	 [mɪst] 
avocado	鳄梨，暗黄绿色	 [ˌævəˈkɑ:dəʊ] 
cherry	樱桃;处女膜	[ˈtʃeri] 
cranberry	酸果蔓的果实	 [ˈkrænbəri] 
grape	葡萄;深紫色	 [greɪp] 
grapefruit	葡萄柚，西柚	 [ˈgreɪpfru:t] 
kiwi	几维鸟，猕猴桃	 [ˈki:wi:] 
mango	芒果	 [ˈmæŋgəʊ] 
melon	甜瓜	 [ˈmelən] 
papaya	番木瓜果	 [pəˈpaɪə] 
pear	梨树	 [peə(r)] 
pineapple	菠萝;凤梨;〈俚〉手榴弹	 [ˈpaɪnæpl] 
tangerine	蜜橘;橘红色	 [ˌtændʒəˈri:n] 
bunch	形成一串，形成一组;打褶	 [bʌntʃ] 
overripe	（尤指水果等）过分成熟的	 [ˌəʊvərˈraɪp] 
ripe	成熟的	 [raɪp] 
rotten	腐烂的;堕落的;非常	 [ˈrɒtn]
condense	压缩;精简;（使）冷凝	 [kənˈdens] 
foam	起泡沫	 [fəʊm] 
plum	葡萄干;李子;紫红色的;称心如意的（工作或职位）	 [plʌm] 
punnet	薄木片制扁篮	 [ˈpʌnɪt] 
pare	削减;修剪（指甲等）	 [peə(r)] 
peel	剥皮;果皮;蔬菜皮	[pi:l] 
restock	重新进货，再储存	 [ˌri:ˈstɒk] 
scramble	攀登;争夺;把…搅乱;[航]紧急起飞	 [ˈskræmbl] 
snap	折断;猛地咬住;呵斥	[snæp] 
asparagus	芦笋	 [əˈspærəgəs] 
broccoli	西兰花	 [ˈbrɒkəli] 
cabbage	卷心菜	 [ˈkæbɪdʒ] 
cauliflower	菜花	 [ˈkɒliflaʊə(r)] 
celery	芹菜	 [ˈseləri] 
eggplant	茄子	 [ˈegplɑ:nt] 
lettuce	生菜	 [ˈletɪs] 
pumpkin	南瓜	[ˈpʌmpkɪn] 
radish	小萝卜	 [ˈrædɪʃ]
spinach	菠菜	 [ˈspɪnɪtʃ] 
bean	豆;毫无价值的东西	 [bi:n] 
bundle	捆;收集;额外免费提供（设备等）;赶	 [ˈbʌndl] 
decayed	烂了的	 [dɪ'keɪd] 
organic	有机（体）的;有组织的	 [ɔ:ˈgænɪk] 
chili	红辣椒	 [ˈtʃɪli]
chive	细洋葱	 [tʃaɪv] 
garlic	大蒜	 [ˈgɑ:lɪk]
onion	洋葱	 [ˈʌnjən] 
scallion	大葱;韭菜	 [ˈskæliən] 
defrost	（使）解冻	 [ˌdi:ˈfrɒst] 
rib	肋骨;开（某人的）玩笑	 [rɪb] 
shank	小腿;钥匙柄;轮轴	 [ʃæŋk] 
veal	小牛	 [vi:l] 
lamb	小羊	 [læm]  
pork	猪肉	 [pɔ:k] 
loin	腰部	 [lɔɪn] 
belly	腹部;食欲;膨胀	 [ˈbeli] 
chop	砍;排骨	 [tʃɒp] 
turkey	火鸡;蠢货	 [ˈtɜ:ki]
breast	胸部;坚毅地面对	 [brest] 
drumstick	鼓槌	 [ˈdrʌmstɪk] 
thigh	大腿	 [θaɪ] 
gram	克;绿豆;	 [græm] 
fillet	用带缚或装饰;把（鱼、肉）切成片	 [ˈfɪlɪt] 
scrape	擦，刮	 [skreɪp] 
shell	外壳;炮弹	 [ʃel] 
cod	鳕鱼;阴囊;包;哄骗	 [kɒd] 
eel	鳗鱼;鳝鱼;小线虫;精明油滑的人	 [i:l]
salmon	鲑鱼;三文鱼;大马哈鱼;	 [ˈsæmən] 
sardine	沙丁鱼;庸碌无能的人;塞满	 [ˌsɑ:ˈdi:n] 
tuna	金枪鱼	 [ˈtju:nə]  
shellfish	贝类动物;甲壳类动物	 [ˈʃelfɪʃ]
clam	蚌，蛤;	 [klæm] 
crab	蟹;发牢骚;偏航	 [kræb] 
lobster	龙虾	 [ˈlɒbstə(r)] 
oyster	牡蛎	[ˈɔɪstə(r)] 
prawn	对虾	 [prɔ:n] 
scallop	扇贝	 [ˈskɒləp] 
shrimp	小虾;矮小的人	 [ʃrɪmp] 
fishy	鬼勾当;腥味儿	 [ˈfɪʃi] 
stinky	发恶臭的	 [ˈstɪŋki] 
abalone	鲍鱼	 [ˌæbəˈləʊni] 
kelp	海带	 [kelp] 
octopus	章鱼	 [ˈɒktəpəs] 
roe	鱼卵;鱼精液;獐鹿	 [rəʊ] 
fin	鱼鳍;散热片;	 [fɪn] 
squid	鱿鱼;乌贼，墨鱼	 [skwɪd] 
stir	搅拌;使打起精神	 [stɜ:(r)] 
margarine	人造黄油;	 [ˌmɑ:dʒəˈri:n] 
flavorless	无味的	 ['fleɪvəlɪs] 
sugary	含糖的	 [ˈʃʊgəri]
liter	[计量] 公升（容量单位）	 ['li:tə(r)] 
ingredient	因素;（烹调的）原料;	 [ɪnˈgri:diənt] 
corned	弄成细粒的，盐腌的	 [kɔ:nd] 
croquette	炸丸子	 [krəʊˈket] 
knuckle	（指人）指关节;（指动物）膝关节;肘	 [ˈnʌkl] 
salami	意大利腊肠	 [səˈlɑ:mi] 
sausage	香肠	 [ˈsɒsɪdʒ] 
sushi	寿司	 [ˈsu:ʃi] 
chunk	（某物）相当大的数量或部分	 [tʃʌŋk] 
chewy	不易嚼碎的	 [ˈtʃu:i] 
exotic	异国的;外来的;奇异的	 [ɪgˈzɒtɪk] 
oily	油腻的，会奉承的	 [ˈɔɪli] 
champagne	香槟酒;平原	 [ʃæmˈpeɪn] 
coke	焦炭	 [kəʊk] 
oolong	乌龙茶	 ['u:lɒŋ] 
diverse	多种多样的	 [daɪˈvɜ:s] 
cap	覆盖;给…戴帽	[kæp] 
tab	帐单;（易拉罐的）拉环;标签	 [tæb] 
lick	舔;轻轻拍打;战胜	 [lɪk] 
dumpling	饺子;水果布丁;矮胖的人	 [ˈdʌmplɪŋ] 
bun	圆形的小面包或点心;（女子的）圆发髻	 [bʌn] 
entree	<法>入场权;<美>主菜	 [ˈɒntreɪ] 
nugget	（天然）块金，块	 [ˈnʌgɪt] 
cloying	使人腻烦的	[ˈklɔɪɪŋ] 
enticing	迷人的	 [ɪnˈtaɪsɪŋ] 
raw	生的;未加工的;无经验的;发炎的	 [rɔ:] 
lolly	棒糖，冰棍儿	 [ˈlɒli] 
sherbet	冰冻果子露	 [ˈʃɜ:bət] 
sundae	圣代冰淇淋	 [ˈsʌndeɪ] 
consumable	可消费的;消费品	 [kənˈsju:məbl] 
chisel	凿;欺骗	 [ˈtʃɪzl] 
screwdriver	螺丝刀;伏特加橙汁鸡尾酒	 [ˈskru:draɪvə(r)] 
cable	绳索;固定系牢;拍发电报	 [ˈkeɪbl] 
deduct	演绎;减去	 [dɪˈdʌkt]
latch	门闩;抓住	 [lætʃ] 
conveyor	传送者	 [kənˈveɪə(r)]  
currency	货币;流通;市价	 [ˈkʌrənsi] 
butcher	肉铺;屠夫;弄砸	 [ˈbʊtʃə(r)] 
disposable	一次性的	 [dɪˈspəʊzəbl]
mannequin	人体模型	 [ˈmænɪkɪn] 
hawker	沿街叫卖者;驯鹰者	 [ˈhɔ:kə(r)] 
stroller	散步者	 [ˈstrəʊlə(r)] 
craft	手艺;船;飞行器;诡计	 [krɑ:ft]
waist	腰;（女人，小孩子的）背心	 [weɪst] 
redeem	兑现;偿还;赎回	 [rɪˈdi:m] 
defective	有瑕疵的	 [dɪˈfektɪv] 
voucher	凭证;收据	[ˈvaʊtʃə(r)] 
ink	墨水;签名（在…上）	 [ɪŋk] 
property	属性;财产	 [ˈprɒpəti]  
administrator	管理者	 [ədˈmɪnɪstreɪtə(r)] 
receptionist	接待员	 [rɪˈsepʃənɪst] 
lousy	讨厌的;污秽的	 [ˈlaʊzi] 
blend	混合;协调	 [blend] 
conceal	隐藏，隐瞒	 [kənˈsi:l] 
manicure	修剪…的指甲;修剪	 [ˈmænɪkjʊə(r)] 
tweeze	以镊子除去	 [twi:z] 
hypoallergenic	低过敏原	 [ˌhaɪpəʊˌælə'dʒenɪk] 
resistant	有抵抗力的;顽固的;防腐剂	 [rɪˈzɪstənt] 
puff	粉扑;一阵（气味，烟雾等）;酥皮点心;吹嘘;膨胀;	 [pʌf] 
exfoliate	鳞片样脱落	 [eksˈfəʊlieɪt] 
serum	血浆;浆液	 [ˈsɪərəm] 
tanning	制革法，皮肤晒成褐色	 ['tænɪŋ]  
greasy	油腻的;谄媚的	 [ˈgri:si]
cotton	棉;	 [ˈkɒtn] 
stool	凳子;大便;长出新枝	 [stu:l] 
pamphlet	小册子	 [ˈpæmflət] 
unzip	拉开…的拉链	 [ˌʌnˈzɪp] 
briefcase	手提箱;手提包	 [ˈbri:fkeɪs] 
diagonal	对角线的;斜的	 [daɪˈægənl] 
pouch	小袋	 [paʊtʃ] 
tote	携带;合计	 [təʊt]
wicker	柳条（编制品）	 [ˈwɪkə(r)] 
beaded	珠状的	 [ˈbi:dɪd] 
exquisite	精致的	 [ɪkˈskwɪzɪt] 
fringy	穗状的	['frɪndʒɪ] 
satin	缎，对（纸等）作加光处理	 [ˈsætɪn] 
striped	有斑纹的;喝醉了的	 [straɪpt]  
catalogue	目录	[ˈkætəlɒg] 
camisole	（贴身）女背心	 [ˈkæmɪsəʊl] 
cardigan	羊毛衫	 [ˈkɑ:dɪgən] 
knit	编织，使皱起	 [nɪt]
leggings	绑腿	 [ˈlegɪŋz] 
sleeve	袖子	[sli:v] 
brooch	胸针	 [brəʊtʃ] 
corsage	<美>装饰女服上身或肩部的小花束	 [kɔ:ˈsɑ:ʒ] 
shawl	围巾，披肩	 [ʃɔ:l] 
dummy	仿制品;沉默寡言的人;笨蛋;挂名的	 [ˈdʌmi] 
tuck	折叠（衣服的）褶;卷起;鼓声;活力	 [tʌk] 
cropped	裁切不正的	 [krɒpt] 
sagging	下垂[沉，陷]	 ['sægɪŋ] 
trousers	裤子	 [ˈtraʊzəz] 
hoodie	连帽衫;穿着连帽衫的小混混	 ['hʊdɪ] 
pleated	起褶的	 [ˈpli:tɪd] 
collar	衣领，扭住领口	 [ˈkɒlə(r)]
trendy	时髦的	 [ˈtrendi] 
accessories	附件;从犯;妇女饰品	 [ək'sesərɪz] 
bow	（向…）弯腰;（使）弯曲	 [bəʊ] 
cuff	护腕;袖口;裤子翻边;<俚>手铐;轻拍	 [kʌf] 
tiepin	领带别针	 [ˈtaɪpɪn] 
guarantee	保证，担保	 [ˌgærənˈti:] 
vacuum	真空;空虚;清洁	 [ˈvækjuəm] 
range	范围;射程;类别;（山脉，房屋等的）排列;徘徊;牧场的	 [reɪndʒ] 
oven	烤箱	 [ˈʌvn] 
purifier	清洁器;精制的;	 [ˈpjʊərɪfaɪə(r)] 
eco	生态的	
tube	管，地铁	 [tju:b] 
thermos	保温瓶	 ['θɜ:məs] 
devour	狼吞虎咽地吃光;吞没;全神贯注地看	 [dɪˈvaʊə(r)]
slurp	啧啧吃的声音	 [slɜ:p] 
chow	原产地中国的狗	[tʃaʊ]
curry	咖喱食品;梳刷（马匹）	 [ˈkʌri] 
sashimi	生鱼片	 [ˈsæʃɪmi] 
udon	乌冬面	 [ju:'dɒn]  
spicy	辛辣的;加有香料的;（故事等）猥亵的	 [ˈspaɪsi] 
yummy	很好吃的	 [ˈjʌmi] 
dining	进餐	 ['daɪnɪŋ] 
tray	托盘	 [treɪ] 
burp	打嗝	 [bɜ:p] 
urinate	撒尿	 [ˈjʊərɪneɪt] 
cradle	摇篮;发源地;支架;婴儿时期	 [ˈkreɪdl] 
nanny	（儿童的）保姆;<口>奶奶;姥姥;母山羊	 [ˈnæni] 
toddler	蹒跚行走的人;幼童装;学步的幼儿	 [ˈtɒdlə(r)] 
alter	改变	[ˈɔ:ltə(r)]
embroider	刺绣;渲染	 [ɪmˈbrɔɪdə(r)] 
sew	缝纫;装钉（书籍）	 [səʊ] 
stitch	缝	 [stɪtʃ] 
bobbin	线轴，绕线筒	 [ˈbɒbɪn] 
seam	煤层;裂缝;缝合	 [si:m] 
ripper	撕裂者，切书机	 [ˈrɪpə(r)] 
stylish	时髦的	 [ˈstaɪlɪʃ] 
lining	衬里	 [ˈlaɪnɪŋ] 
petticoat	衬裙	 [ˈpetɪkəʊt] 
flop	彻底失败;（因疲惫而）猛然坐下;（笨拙地、不由自主地或松弛地）移动或落下	 [flɒp] 
heel	脚后跟，倾斜	 [hi:l] 
loafer	游手好闲者; 无业游民;平底便鞋	 [ˈləʊfə(r)] 
sandal	凉鞋	 [sændlz] 
slipper	拖鞋;（小孩的）围兜;放猎狗的猎人	 [ˈslɪpə(r)] 
slip	滑;犯过失;（健康状况等）变差;摆脱;跌倒;纸条;可拆卸的	 [slɪp] 
edition	版本;一版	 [ɪˈdɪʃn] 
insole	鞋垫	 [ˈɪnsəʊl] 
lace	蕾丝;鞋带;系带;给（书、讲话等）润色;给（饮料等）掺（少量的酒、药、毒药等）	 [leɪs] 
shoelace	鞋带	 [ˈʃu:leɪs] 
tip	小费;小窍门;末梢;倾斜	 [tɪp] 
vamp	拼凑;勾引男子;换修（靴或鞋）的面;即席奏出	 [væmp] 
privacy	隐私	 [ˈprɪvəsi] 
policy	政策;保险单	[ˈpɒləsi] 
auctioneer	拍卖	 [ˌɔ:kʃəˈnɪə(r)] 
shopaholic	购物狂	 [ˌʃɒpəˈhɒlɪk] 
knockoff	名牌仿制品	 ['nɒkɔ:f] 
scam	骗局	 [skæm] 
recommend	推荐;使显得吸引人;托付	 [ˌrekəˈmend] 
case	事例;容器（箱，盒）;包围;探察	[keɪs] 
burner	炉子;灯光	 [ˈbɜ:nə(r)] 
motherboard	底板	 [ˈmʌðəbɔ:d] 
technician	技术人员	 [tekˈnɪʃn] 
salesclerk	店员	 ['seɪlzklɑ:k] 
inquiry	调查;询问	 [ɪn'kwaɪərɪ]
headset	戴在头上的耳机或听筒	 [ˈhedset]
laser	激光;激光器	 [ˈleɪzə(r)] 
webcam	网络摄像机	 [ˈwebkæm] 
optical	光学的;视觉的	 [ˈɒptɪkl] 
disc	圆盘;磁盘;唱片	[dɪsk] 
rub	摩擦;阻碍	[rʌb]
lens	镜头;眼睛中的水晶体;隐形眼镜;汽车的灯玻璃	[lenz] 
telephoto	远距摄影照片	 ['telɪ'fəʊtəʊ] 
reflex	反应能力;反射;反省的;复印;影像	 [ˈri:fleks] 
amateur	业余的	[ˈæmətə(r)] 
aperture	孔;（照相机，望远镜等的）光圈	 [ˈæpətʃə(r)] 
viewfinder	（照相机）取景器	 [ˈvju:faɪndə(r)]  
mute	哑的;使…柔和	 [mju:t] 
ray	射线;光束;微量	 [reɪ] 
vague	模糊的;暧昧的	 [veɪg] 
dial	表盘;日晷;打电话	 [ˈdaɪəl]
charger	充电器;战马	 [ˈtʃɑ:dʒə(r)]
lithium	<化>锂	 [ˈlɪθiəm] 
slot	位置;狭槽；水沟;跟踪	 [slɒt] 
strap	用带捆扎;用皮带抽打;拼命工作	 [stræp] 
biography	传记	 [baɪˈɒgrəfi] 
literature	文学作品	 [ˈlɪtrətʃə(r)] 
fiction	小说	 [ˈfɪkʃn] 
nonfiction	非小说类文学作品	 [ˌnɒn'fɪkʃən] 
appendix	附录;阑尾;附加物	 [əˈpendɪks] 
postscript	（信末签名后的）附言	 [ˈpəʊstskrɪpt] 
preface	序言	 [ˈprefəs] 
clamor	喧哗声，大声的要求或抗议	 ['klæmə] 
flap	扁平物;拍打;恐慌;摆动	 [flæp] 
scream	尖声喊叫	 [skri:m] 
alphabet	字母表;入门	 [ˈælfəbet] 
fable	寓言;虚构	 [ˈfeɪbl] 
fairy	仙女	 [ˈfeəri] 
tale	传说;（尤指充满惊险的）故事;谣言	[teɪl] 
myth	神话	 [mɪθ] 
jigsaw	钢丝锯;拼板玩具	 [ˈdʒɪgsɔ:] 
innocent	天真无邪的;无辜的	 [ˈɪnəsnt] 
lively	活泼的	 [ˈlaɪvli] 
beanbag	内装豆子的小布袋（小孩用作玩具）	 [ˈbi:nbæg] 
clap	拍手;轻轻拍打某人;拍翅膀;噼拍声	 [klæp] 
dim	暗淡的，傻子	 [dɪm] 
blogger	博客	 ['blɒɡə(r)] 
chef	厨师	 [ʃef] 
critic	批评家;评论员	 [ˈkrɪtɪk] 
gastronome	美食者	 ['gæstrənəʊm] 
firmly	坚定地	 [ˈfɜ:mli] 
moderate	适度的;使和缓;主持	 [ˈmɒdərət] 
sarcastic	讥讽的	 [sɑ:ˈkæstɪk] 
witty	诙谐的;机智的	 [ˈwɪti] 
fluid	液体;易变的	 [ˈflu:ɪd] 
aqueous	水的	 [ˈeɪkwiəs] 
delicate	微妙的;熟练的;纤弱的	 [ˈdelɪkət] 
fragrant	芳香的;愉快的	 [ˈfreɪgrənt] 
handy	方便的;手巧的;手边的	 [ˈhændi]
refillable	适于再装的（如包装材料等）	 [ˌri:'fɪləbl]  
retractable	可收回的;可撤消的;可缩回的	 [rɪˈtræktəbl] 
flourish	挥舞;茂盛;华丽的辞藻;夸张的行为或手势	 [ˈflʌrɪʃ] 
wither	使枯萎	 [ˈwɪðə(r)] 
bougainvillea	叶子花属	 [ˌbu:gənˈvɪliə]
orchid	兰花	 [ˈɔ:kɪd] 
cactus	仙人掌	 [ˈkæktəs] 
camellia	山茶花	[kəˈmi:liə] 
dahlia	天竺牡丹	 [ˈdeɪliə] 
flamingo	火烈鸟	 [fləˈmɪŋgəʊ] 
hydrangea	八仙花属	 [haɪˈdreɪndʒə] 
jasmine	茉莉;淡黄色	 [ˈdʒæzmɪn] 
glory	荣誉;壮观;（对上帝的）赞颂;骄傲	[ˈglɔ:ri] 
narcissus	水仙花	[nɑ:ˈsɪsəs] 
pansy	三色紫罗兰，同性恋男子	 [ˈpænzi] 
peony	牡丹	[ˈpi:əni] 
fertilizer	化肥;促进发展者	[ˈfɜ:təlaɪzə(r)]
floral	花的，植物的	 [ˈflɔ:rəl] 
clipper	剪刀，移动很快的人或物	 [ˈklɪpə(r)] 
blossom	开花时期，兴旺时期	 [ˈblɒsəm]  
snip	剪;（剪下的）片断;藐小的人	 [snɪp] 
calla	马蹄莲	 ['kælə] 
lily	百合花;纯洁的人	 [ˈlɪli] 
carnation	康乃馨;淡红色	 [kɑ:ˈneɪʃn] 
chrysanthemum	菊花	 [krɪˈsænθəməm]  
daisy	雏菊;上等的	 [ˈdeɪzi] 
hyacinth	洋水仙	 [ˈhaɪəsɪnθ] 
iris	虹膜;鸢尾属植物	 [ˈaɪrɪs]  
marguerite	雏菊	 [ˌmɑ:gəˈri:t] 
sunflower	向日葵	 [ˈsʌnflaʊə(r)] 
tulip	郁金香	 [ˈtju:lɪp] 
violet	紫罗兰;羞怯的人	 [ˈvaɪələt] 
odorous	有气味的	 [ˈəʊdərəs] 
scentless	无气味的	 [ˈsentləs] 
showy	引人注目的;过分装饰的	 [ˈʃəʊi] 
artificial	人造的;虚假的;非原产地的	 [ˌɑ:tɪˈfɪʃl] 
bouquet	花束;酒香	 [buˈkeɪ] 
cellophane	玻璃纸	 ['seləfeɪn] 
crepe	绉绸	 [kreɪp] 
garland	花环	[ˈgɑ:lənd] 
ribbon	带	 [ˈrɪbən]  
comforter	安慰者;羊毛围巾	 [ˈkʌmfətə(r)] 
duvet	羽绒被	 [ˈdu:veɪ]  
fitted	合适的;订做的;有…设备的	 [ˈfɪtɪd] 
durable	耐用的	 [ˈdjʊərəbl] 
fluffy	松软的;肤浅的	 [ˈflʌfi] 
shade	遮蔽;险胜;逐渐变化	 [ʃeɪd] 
nightstand	放在床头边的小桌	 [ˈnaɪtstænd] 
mount	登上;增加;镶嵌;山峰	 [maʊnt] 
bathtub	浴缸	 [ˈbɑ:θtʌb] 
caddy	茶叶罐;小盒子;杂役	 [ˈkædi] 
sink	使下沉;水池	 [sɪŋk] 
robe	睡袍;礼服	 [rəʊb] 
tumbler	翻筋斗者;（机枪的）机心;（玩具）不倒翁	 [ˈtʌmblə(r)] 
footstool	脚凳	 [ˈfʊtstu:l] 
liquor	酒	 [ˈlɪkə(r)] 
interior	内部	 [ɪnˈtɪəriə(r)] 
newlyweds	新婚夫妇	 [n'ju:lɪwedz] 
tieback	用以拉窗帘的带	 ['taɪbæk]  
smash	打碎;撞击;猛扣（球等）	 [smæʃ] 
countertop	（厨房的）工作台面	 [ˈkaʊntətɒp] 
paring	削下的皮	 ['peərɪŋ] 
sideboard	餐具橱	 [ˈsaɪdbɔ:d] 
blunt	迟钝的;钝的;小雪茄烟	 [blʌnt]  
nonstick	（锅）锅底不粘的	 [nɒns'tɪk]  
patent	专利;明摆着的	[ˈpætnt] 
stainless	不锈的;无污点的	 ['steɪnlɪs]
unique	唯一的	 [juˈni:k] 
corkscrew	螺丝锥，螺旋形的	 [ˈkɔ:kskru:] 
illustrate	（用示例、图画等）说明	[ˈɪləstreɪt] 
modular	模块化的	 [ˈmɒdjələ(r)] 
stuck	被卡住的	 [stʌk] 
manual	手工的;手册;	 [ˈmænjuəl] 
workbench	工作台	[ˈwɜ:kbentʃ] 
adhesive	可黏着的	 [ədˈhi:sɪv] 
cardboard	硬纸板;虚假的	[ˈkɑ:dbɔ:d] 
appointed	指定的	 [ə'pɔɪntɪd] 
fragile	易碎的，虚弱的	 [ˈfrædʒaɪl] 
massive	大量的;魁伟的	 [ˈmæsɪv]
commodity	商品;有利	 [kəˈmɒdəti] 
consignment	装运的货物	 [kənˈsaɪnmənt] 
customize	定制	 [ˈkʌstəmaɪz] 
laminate	由薄片叠成的	 [ˈlæmɪnət] 
retouch	润色	 [ˌri:ˈtʌtʃ] 
photographic	摄影用的;逼真的;（尤指记忆）记得详细准确的	 [ˌfəʊtəˈgræfɪk] 
studio	工作室;[影]演播室;电影制片厂	 [ˈstju:diəʊ] 
glossy	有光泽的;虚有其表的	 [ˈglɒsi] 
matt	表面暗淡的	 [mæt]  
overexpose	使感光过度	 [ˌəʊvərɪkˈspəʊz] 
underexpose	使（底片）曝光不足	 [ˌʌndərɪkˈspəʊz] 
starch	淀粉;形式主义;僵硬;给…上浆	 [stɑ:tʃ] 
coin	硬币;杜撰;创造	 [kɔɪn] 
stain	玷污，给…染色	 [steɪn] 
stiff	严厉的;僵硬的;极度地;死尸;笨蛋;诈骗	 [stɪf] 
wrinkled	有皱纹的	[ˈrɪŋkld]
diagnose	诊断	 [ˈdaɪəgnəʊz] 
discern	辨明	 [dɪˈsɜ:n] 
rimless	无边的	 [ˈrɪmləs] 
cashier	出纳员;解雇;抛弃	[kæˈʃɪə(r)] 
nearsighted	近视的，浅见的	 [ˌnɪəˈsaɪtɪd]  
optician	眼镜（制造）商，配制眼镜技师	 [ɒpˈtɪʃn] 
optometrist	验光师	 [ɒpˈtɒmətrɪst]  
saline	含盐的，咸的	 [ˈseɪlaɪn] 
Snellen chart	斯内伦视力表	 [ˈsnelən] 
astronomic	天文学的	 [ˌæstrə'nɒmɪk] 
chronograph	记时计	 [ˈkrɒnəgrɑ:f] 
dive	潜水;急剧下降	 [daɪv]
kinetic	运动的	 [kɪˈnetɪk] 
mechanical	呆板的;机械的	 [məˈkænɪkl] 
quartz	石英	 [kwɔ:ts] 
wrist	腕	 [rɪst] 
antimagnetic	防磁的	 [ænti:mæɡ'netɪk] 
electronic	电子的	 [ɪˌlekˈtrɒnɪk] 
rustproof	防锈的	 [ˈrʌstpru:f] 
accordion	手风琴;可折叠的	 [əˈkɔ:diən] 
cello	大提琴	 [ˈtʃeləʊ]  
clarinet	单簧管	 [ˌklærəˈnet] 
oboe	欧巴，双簧管	 [ˈəʊbəʊ] 
organ	器官;机构;风琴;元件	 [ˈɔ:gən] 
panpipe	排箫	
saxophone	萨克斯管	 [ˈsæksəfəʊn]  
timpani	定音鼓	 [ˈtɪmpəni] 
trumpet	喇叭;大声说出或宣告	 [ˈtrʌmpɪt]  
drummer	鼓手	 [ˈdrʌmə(r)] 
drum	鼓;反复讲;连打	 [drʌm] 
bead	念珠;起泡	 [bi:d] 
knot	结;海里	 [nɒt] 
pendant	（装在项链等上的）垂饰	 [ˈpendənt] 
rhinestone	人造钻石	[ˈraɪnstəʊn] 
sequin	（衣服上的圆形）闪光装饰片	 [ˈsi:kwɪn] 
yarn	线;故事	 [jɑ:n] 
crochet	用钩针编织	 [ˈkrəʊʃeɪ] 
knit	编结;接合（折骨等）;使皱起	 [nɪt] 
pliers	钳子	 [ˈplaɪəz]  
adorable	可敬重的，讨人喜欢的	 [əˈdɔ:rəbl] 
coarse	粗糙的;粗鄙的	 [kɔ:s] 
shiny	发光的	 [ˈʃaɪni] 
anklet	短袜;踝环	 [ˈæŋklət] 
charm	诱惑;对…行魔法;令人陶醉	 [tʃɑ:m] 
charge	装载;控诉;使充电;索价	 [tʃɑ:dʒ] 
accommodation	住处;适应;和解;便利	 [əˌkɒməˈdeɪʃn]  
itinerary	旅程	 [aɪˈtɪnərəri] 
domestic	佣人;国货	 [dəˈmestɪk] 
overseas	（在）海外的	 [ˌəʊvəˈsi:z] 
visa	签证	 [ˈvi:zə] 
sightseer	游客	
trustworthy	值得信赖的	 [ˈtrʌstwɜ:ði] 
hesitate	犹豫	 [ˈhezɪteɪt] 
soothe	安慰;缓和	 [su:ð]  
vend	出售;发表（意见，言论）	 [vend]
figure	人物;数字;身材;计算;估计;出现;扮演角色	 [ˈfɪgə(r)] 
lego	乐高	
monopoly	垄断	 [məˈnɒpəli] 
slinky	偷偷摸摸的，体态富于曲线的	 [ˈslɪŋki] 
teddy	妇女连衫衬裤;泰迪玩具熊	 ['tedɪ] 
joyful	快乐的	[ˈdʒɔɪfl]
overwhelming	势不可挡的	 [ˌəʊvəˈwelmɪŋ] 
preschool	就学前的，幼儿园	[ˈpri:sku:l] 
glitter	闪烁;（表面的）诱惑力	 [ˈglɪtə(r)] 
peer	凝视;若隐若现;同等;同辈;贵族	 [pɪə(r)] 
shoplift	在商店偷窃	 ['ʃɒplɪft] 
sting	刺，叮;（警察为抓捕罪犯而设的）圈套	 [stɪŋ] 
halogen	卤素	 [ˈhælədʒən] 
loupe	小型放大镜	 [lu:p] 
showcase	在玻璃橱窗陈列	 [ˈʃəʊkeɪs] 
winder	会缠绕的植物，螺旋形阶梯	 [ˈwaɪndə(r)] 
corporate	法人的，全体的	[ˈkɔ:pərət] 
bigwig	有重大影响的人	 [ˈbɪgwɪg] 
swindler	骗子	 ['swɪndlə(r)] 
gemstone	经雕琢的宝石	 ['dʒemstəʊn] 
masterpiece	杰作	 [ˈmɑ:stəpi:s] 
pierce	刺穿;洞察;深深打动	 [pɪəs] 
barrette	（妇女用的）条状发夹	 [bæˈret] 
claw	（动物的）爪	 [klɔ:] 
exaggerated	夸大的	 [ɪgˈzædʒəreɪtɪd]
glittering	闪闪发光的;辉煌的	 [ˈglɪtərɪŋ]  
gorgeous	美丽动人的	 [ˈgɔ:dʒəs] 
tacky	俗气的;发黏的;褴褛的	 [ˈtæki] 
tawdry	华而不实的	 [ˈtɔ:dri] 
enclose	（用墙、篱笆等）把…围起来;把…装入信封;附入	 [ɪnˈkləʊz] 
ashtray	烟灰缸	 [ˈæʃtreɪ]
jewel	宝石;受珍视的人[物]	 [ˈdʒu:əl] 
prank	恶作剧;打扮;炫耀自己	[præŋk] 
piggy	小猪;贪心的	 [ˈpɪgi] 
coveted	令人垂涎的	
appreciate	欣赏;感激;鉴别;（使）增值	 [əˈpri:ʃieɪt] 
stare	凝视;显眼;倒立	 [steə(r)] 
betta	搏鱼	 [ˈbetə] 
clown	小丑;乡下人;小气鬼	 [klaʊn] 
crawfish	小龙虾	[ˈkrɔ:fɪʃ] 
hawksbill	玳瑁（一种中型海龟）	['hɔ:ksbɪl]
loach	泥鳅	 [ləʊtʃ] 
paradise	天堂;伊甸园	[ˈpærədaɪs]
algae	水藻	 [ˈældʒi:]  
moss	苔藓	 [mɒs] 
remodel	改变…的结构[形状]	[ˌri:ˈmɒdl] 
carburetor	化油器	 ['kɑ:bjʊretə] 
exhaust	耗尽;排气	 [ɪgˈzɔ:st] 
radiator	暖气片;（汽车引擎的）冷却器	 [ˈreɪdieɪtə(r)] 
spark	电火花;发动	 [spɑ:k] 
taillight	（车辆的）后灯	 ['teɪllaɪt] 
rim	（圆形器皿的）边	 [rɪm] 
jack	千斤顶;提高;插座;男人;纸牌中的J	 [dʒæk] 
clutch	离合器;紧抓;紧要关头	 [klʌtʃ] 
kickstand	（自行车或摩托车的）撑脚架	 [ˈkɪkstænd] 
valve	阀;真空管;（心脏的）瓣膜	 [vælv] 
torch	手电筒;火把;放火烧	 [tɔ:tʃ] 
stimulate	激励	 [ˈstɪmjuleɪt] 
carriage	运费;运输	 [ˈkærɪdʒ] 
pail	桶	 [peɪl] 
breastfeed	用母乳喂养	 [ˈbrestfi:d] 
groan	呻吟	 [grəʊn] 
infect	使受影响，感染	 [ɪnˈfekt] 
isolate	使隔离	 [ˈaɪsəleɪt] 
moan	呻吟	 [məʊn] 
pet	宠物;宠儿	 [pet]
scrunch	蜷缩;挤压	 [skrʌntʃ] 
tease	挑逗;梳理（羊毛等）	 [ti:z] 
microchip	微型集成电路片	 [ˈmaɪkrəʊtʃɪp] 
implantation	植入;培植，灌输	 [ˌɪmplɑ:n'teɪʃn] 
accessory	附件;从犯;（衣服的）配饰	 [əkˈsesəri]
tag	附加;加标签于;起诉;紧跟	 [tæg] 
rabies	狂犬病	 [ˈreɪbi:z] 
vaccine	疫苗	 [ˈvæksi:n]
ferocious	残忍的	 [fəˈrəʊʃəs] 
preorder	前序;预订	 [pri:'ɔ:də] 
brownie	巧克力蛋糕;6-8岁的女童子军	 [ˈbraʊni] 
caramel	焦糖	 [ˈkærəmel]
tart	尖刻的;果馅饼;轻佻的女人	 [tɑ:t] 
taro	芋头	 ['tɑ:rəʊ] 
tiramisu	提拉米苏	 [ˌtɪrəmɪ'sʊ] 
apprentice	学徒	[əˈprentɪs] 
pastry	糕点	 [ˈpeɪstri] 
cutlery	刀具	 [ˈkʌtləri] 
bagel	硬面包圈	 [ˈbeɪgl] 
baguette	法国长面包	 [bæˈget] 
brioche	奶油糕点	 [briˈɒʃ] 
croissant	羊角面包	 ['krwæsɒ̃]  
custard	蛋羹	 [ˈkʌstəd] 
Danish	丹麦的;丹麦语	 [ˈdeɪnɪʃ] 
donut	甜甜圈	 [ˈdəuˌnʌt] 
grain	谷物;籽粒;（木材，大理石等的）纹理	 [greɪn] 
muffin	杯状小松糕	 [ˈmʌfɪn]  
waffle	华夫饼;胡扯	 [ˈwɒfl] 
battered	破旧的;磨损的;受虐待的	 [ˈbætəd] 
savory	香薄荷;好吃的;体面的	['seɪvərɪ]
tong	钳;帮会	 [tɒŋ]
jam	果酱;挤满;困境;	 [dʒæm]
ferment	发酵剂;酶;骚动	 [fəˈment]
grease	动物油脂;润滑油;〈俚〉贿赂	 [gri:s] 
preheat	预热	 [ˌpri:ˈhi:t] 
flour	面粉	 [ˈflaʊə(r)] 
sifter	（用于筛撒粉状食物的）筛具，撒粉器;	 [ˈsɪftə(r)] 
chilled	冷硬了的	 [tʃɪld] 
soggy	湿透的，乏味的	[ˈsɒgi] 
dough	生面团	 [dəʊ] 
icing	结冰;糖衣，酥皮	 [ˈaɪsɪŋ] 
yeast	酵母;泡沫;动乱	 [ji:st] 
cappuccino	卡普契诺咖啡	 [ˌkæpuˈtʃi:nəʊ] 
macchiato	玛奇雅朵咖啡	
espresso	浓咖啡	 [eˈspresəʊ] 
Irish	爱尔兰的，爱尔兰语	 [ˈaɪrɪʃ] 
latte	拿铁咖啡	 [ˈlɑ:teɪ] 
mocha	摩卡咖啡;优等咖啡	 [ˈmɒkə] 
estate	财产;（较高的）社会地位	 [ɪˈsteɪt] 
Americano	美式咖啡	
Colombian	哥伦比亚的	 [kə'lɒmbɪən] 
decaffeinated	脱去咖啡因的	 [ˌdi:ˈkæfɪneɪtɪd] 
whip	鞭打;烘干;立法机构的一员	 [wɪp] 
frother	泡沫剂	 [f'rɒðər] 
pitcher	大水罐;投掷的人	 [ˈpɪtʃə(r)] 
wand	魔杖;指挥棒;嫩枝;（做箭靶的）狭长木板	 [wɒnd] 
bitter	苦的;尖锐的;严寒的;怀恨的	 [ˈbɪtə(r)] 
syrup	糖浆	 [ˈsɪrəp] 
hazelnut	榛子	 [ˈheɪzlnʌt]
vanilla	香草，普通的	 [vəˈnɪlə] 
refill	重新装满	 [ˌri:ˈfɪl] 
garbage	垃圾	 [ˈgɑ:bɪdʒ] 
busboy	餐馆工	 [ˈbʌsbɔɪ]
patron	资助人;顾客;守护神	 [ˈpeɪtrən] 
sommelier	斟酒服务员	[sə'melɪeɪ] 
vegetarian	素食者	 [ˌvedʒəˈteəriən]  
appetizer	开胃品	[ˈæpɪtaɪzə(r)] 
decoct	煎（药等）	 ['dɪ'kɒkt] 
stove	火炉;窑;干燥室	 [stəʊv]  
spice	香料，情趣	 [spaɪs] 
broad	广泛的;概括的;明显的;婆娘	 [brɔ:d] 
paste	面团;糨糊;粘贴	 [peɪst] 
caterer	（尤指职业的）酒席承办人	 [ˈkeɪtərə(r)] 
gourmet	美食家	[ˈgʊəmeɪ] 
steamer	蒸锅;汽船;蒸汽机	 [ˈsti:mə(r)]
broil	（用火）烤（焙、炙等）;使卷入争吵;使混乱	 [brɔɪl] 
marinate	腌制	 [ˈmærɪneɪt] 
savor	加调味品于;使有风味	['seɪvə]
casserole	砂锅	 [ˈkæsərəʊl] 
sake	缘故;日本米酒;目的	 [seɪk] 
sharpener	卷笔刀;磨具	 [ˈʃɑ:pnə(r)] 
wasabi	芥末	 [wəˈsɑ:bi]  
loyal	忠诚的	 [ˈlɔɪəl] 
shoji	<日>障子（日本房屋用的纸糊木框）	 ['ʃəʊdʒɪ] 
tatami	<日>榻榻米（日本人铺在室内地板上的稻草垫）	 [təˈtɑ:mi] 
sip	从…中呷吸	 [sɪp] 
eggbeater	打蛋器，<美俚>直升飞机	 ['egˌbi:tə] 
kettle	（烧水用的）壶	 [ˈketl] 
graceful	优雅的	 [ˈgreɪsfl] 
refined	精炼的	 [rɪˈfaɪnd] 
fondue	火锅	 [ˈfɒndju:] 
dice	骰子;将…切成丁	 [daɪs] 
gulp	狼吞虎咽地吃	 [gʌlp] 
guzzle	狂吃暴饮	 [ˈgʌzl]  
mince	剁碎;碎步走;装腔作势地说	 [mɪns]
swallow	吞;忍受;[鸟]燕子;食道	 [ˈswɒləʊ] 
conveyer	运输机	 [kən'veɪə] 
toaster	烤面包片机	[ˈtəʊstə(r)] 
roaster	乳猪;烘烤器;焙烤工	 ['rəʊstə] 
slush	烂泥	 [slʌʃ] 
soup	汤，困境	 [su:p] 
juicy	多汁的;有趣的;报酬多的	 [ˈdʒu:si] 
dessert	甜点	 [dɪˈzɜ:t] 
sukiyaki	寿喜烧（日本菜的一种）	 [ˌsu:ki:'jɑ:ki:]  
cupboard	壁橱	 [ˈkʌbəd] 
bento	盒饭或饭盒	 ['bentəʊ] 
reprocess	再加工	 [ri:'prəʊses] 
griddle	煎饼用浅锅;筛	 [ˈgrɪdl] 
parasol	太阳伞	 [ˈpærəsɒl] 
signboard	广告牌	 [ˈsaɪnbɔ:d] 
omelet	煎蛋卷	 ['ɒmlɪt] 
skim	略读;使掠过;撇去的东西;（为逃税而）隐瞒（部分收入）	[skɪm] 
soybean	大豆，黄豆	 ['sɔɪbi:n] 
discard	抛弃，解雇，出牌	 [dɪsˈkɑ:d] 
chatter	唠叨;振动;（鸟等）鸣	 [ˈtʃætə(r)] 
churn	搅拌;制造（奶油等）	 [tʃɜ:n] 
spoon	匙;轻轻向上击	 [spu:n] 
crusher	压碎的东西，镇服人的事实	 [ˈkrʌʃə(r)] 
spade	铁锹;纸牌中的黑桃	 [speɪd] 
popsicle	冰棍儿	 [ˈpɔpsikl] 
smoothie	冰沙;善于讨好女人的男子;举止优雅的人	 [ˈsmu:ði]
sorbet	果汁冰糕	 [ˈsɔ:beɪ] 
ginger	生姜;活力	 [ˈdʒɪndʒə(r)] 
aloe	芦荟	[ˈæləʊ] 
jelly	果冻	 [ˈdʒeli] 
herbal	药草的	[ˈhɜ:bl] 
pitch	音高;场地;用沥青涂;抛	 [pɪtʃ] 
poke	刺	 [pəʊk] 
hoopla	喧闹，投环套物游戏	[ˈhu:plɑ:] 
pinball	弹球	 [ˈpɪnbɔ:l] 
balloon	气球;膨胀	 [bəˈlu:n] 
capsule	胶囊;航天舱;压缩;简述;以瓶盖密封	 [ˈkæpsju:l] 
braised	炖熟的	 [breɪzd] 
doughnut	炸面圈;汽车轮胎;环状物	 ['dəʊnʌt] 
recycle	回收利用	 [ˌri:ˈsaɪkl] 
parcel	包裹;区分;一批	 [ˈpɑ:sl] 
sticker	给…贴上标签价;坚持不懈的人;使人为难的东西	 [ˈstɪkə(r)] 
tear	撕裂;眼泪	 [teə(r)]  
wire	电线;电报;背后操纵的势力	 [ˈwaɪə(r)]
thru	直至	 [θru:] 
depositor	存款人	 [dɪˈpɒzɪtə(r)] 
executive	总经理;行政部门	 [ɪgˈzekjətɪv] 
payee	收款人	[ˌpeɪˈi:] 
safecracker	保险箱窃贼	 ['seɪfˌkrækə] 
receipt	收据	 [rɪˈsi:t] 
remittance	汇款	 [rɪˈmɪtns] 
withdrawal	撤回	 [wɪðˈdrɔ:əl] 
passbook	存折	 [ˈpɑ:sbʊk] 
beneficiary	受益人	[ˌbenɪˈfɪʃəri] 
remitter	汇款人	 [rɪ'mɪtə] 
transaction	交易	 [trænˈzækʃn] 
guaranteed	有人担保的	 ['gærən'ti:d] 
queue	队列;辫子	 [kju:]
endorser	代言人	 [ɪn'dɔ:sə] 
remittee	汇款收款人	 [rɪmɪ'ti:] 
certificate	证明书;文凭	 [səˈtɪfɪkət] 
convert	（使）转变;使皈依;兑换;侵占	 [kənˈvɜ:t] 
countersign	<术>连署	 [ˈkaʊntəsaɪn]  
quote	引述;报价;引号	 [kwəʊt] 
dime	 (美国货币中的)10分硬币 	 [daɪm] 
nickel	 镍;（美国和加拿大的）5分镍币 	 [ˈnɪkl] 
baht	泰铢	 ['bət] 
euro	欧元	 [ˈjʊərəʊ]  
pound	磅;英镑;重击声	 [paʊnd] 
ruble	卢布	 [ˈru:bl] 
yen	日元;渴望	 [jen] 
emigrant	移民	 [ˈemɪgrənt] 
immigrant	移民	 [ˈɪmɪgrənt] 
invest	投资;使就职;装饰;使充满;覆盖	 [ɪnˈvest] 
mortgage	抵押	 [ˈmɔ:gɪdʒ] 
insurance	保险	 [ɪnˈʃʊərəns] 
loan	贷款;借出	 [ləʊn] 
portfolio	证券投资组合;公文包;代表作品集;部长[大臣]的职位	 [pɔ:tˈfəʊliəʊ] 
aggressive	有进取心的;侵犯的	 [əˈgresɪv] 
debtor	借方	 [ˈdetə(r)] 
financial	金融的;财务的	 [faɪˈnænʃl] 
consultant	顾问	 [kənˈsʌltənt]  
guarantor	担保人	 [ˌgærənˈtɔ:(r)] 
investor	出资者	 [ɪnˈvestə(r)] 
rally	集合;反弹;反败为胜	 [ˈræli] 
transact	交易;办理（业务等）	 [trænˈzækt] 
bond	债券;纽带;保释金	[bɒnd] 
capital	资本的;首都的;极好的;死刑的;大写字母	 [ˈkæpɪtl] 
rate	速度;比率;等级;责骂	[reɪt] 
share	股;分享	 [ʃeə(r)] 
turnover	翻倒;逆转;营业额	 [ˈtɜ:nəʊvə(r)]
bearish	（尤指脾气）像熊一样的;<股>行情下跌的	 [ˈbeərɪʃ] 
bullish	公牛般的;[商]股票行情看涨的;	 [ˈbʊlɪʃ] 
listed	列入文物保护名册的;登记上市的	 ['lɪstɪd] 
institutional	由来已久的; 公共机构的; 慈善机构的	 [ˌɪnstɪˈtju:ʃənl] 
speculator	投机倒把者;思索者;〈美〉垄断收买（戏票）的人	[ˈspekjuleɪtə(r)] 
accuse	指控	 [əˈkju:z]  
investigate	调查	 [ɪnˈvestɪgeɪt] 
badge	徽章	 [bædʒ] 
baton	接力棒;（警察武器）警棍;（乐队指挥用的）指挥棒	 ['bætɒn] 
breathalyzer	呼吸测醉器	 ['breθəˌlaɪzə] 
fluorescent	荧光的;日光灯	 [ˌflɔ:ˈresnt] 
handcuff	手铐	 [ˈhændkʌf] 
shackle	束缚，加枷锁	 [ˈʃækl] 
walkie talkie	对讲机	
whistle	吹口哨，鸣汽笛	 [ˈwɪsl] 
suspect	怀疑;嫌疑犯	 [səˈspekt] 
victim	受害者;为祭祀杀死的动物（或人）	[ˈvɪktɪm] 
custody	监管;拘留;抚养权	 [ˈkʌstədi] 
forensic	法庭的;公开辩论的	 [fəˈrensɪk] 
saliva	唾液	 [səˈlaɪvə] 
interrogation	审问;疑问句	 [ɪnˌterə'ɡeɪʃn]  
aerial	空气的;空中的;空想的	 [ˈeəriəl] 
marshal	元帅;典礼官;执法官;消防局长;排列	 [ˈmɑ:ʃl] 
squad	（军队中的）班;体育运动的运动（代表）队	 [skwɒd] 
paramedic	护理人员	 [ˌpærəˈmedɪk] 
rescue	营救	 [ˈreskju:] 
defend	保卫;辩护	 [dɪˈfend] 
overrule	否决;统治	 [ˌəʊvəˈru:l] 
prosecute	起诉	 [ˈprɒsɪkju:t] 
summon	召唤;传讯（出庭）;[军]招降	 [ˈsʌmən] 
testify	作证;公开宣称	 [ˈtestɪfaɪ] 
alibi	为…辩解;为（某人）提供不在现场的证词	 [ˈæləbaɪ] 
immunity	免疫力;免除	 [ɪˈmju:nəti] 
testimony	（法庭上证人的）证词	 [ˈtestɪməni] 
verdict	（陪审团的）裁决	 [ˈvɜ:dɪkt]
penalty	惩罚;害处;足球点球	 [ˈpenəlti] 
deprivation	剥夺	 [ˌdeprɪˈveɪʃn] 
imprisonment	关押	 [ɪm'prɪznmənt] 
probation	试用（期）;缓刑（期）;查看	 [prəˈbeɪʃn] 
bailiff	法警;执行官	 [ˈbeɪlɪf] 
defendant	被告人	 [dɪˈfendənt] 
jury	陪审团;（展览会，竞赛等的）全体评审员;应急的	 [ˈdʒʊəri] 
plaintiff	原告	 [ˈpleɪntɪf] 
prosecutor	检察官	 [ˈprɒsɪkju:tə(r)] 
cunning	狡猾的	 [ˈkʌnɪŋ] 
eloquent	雄辩的;逼真的	 [ˈeləkwənt] 
approve	赞成	 [əˈpru:v] 
imprison	关押	 [ɪmˈprɪzn] 
punish	处罚	 [ˈpʌnɪʃ] 
armed	武装的;有把手的	[ɑ:md] 
chamber	室;幽禁	 [ˈtʃeɪmbə(r)] 
lodge	提出（报告、要求、申诉等）;寄存;把（权利、权威等）授予;小屋	 [lɒdʒ] 
barred	被禁止的	 [bɑ:d] 
protective	保护的	 [prəˈtektɪv] 
condemned	被宣告有罪的	 [kən'demd] 
inmate	居民;同居者;（监狱里的）犯人	 [ˈɪnmeɪt]  
warden	典狱官	 [ˈwɔ:dn] 
rifle	来福枪;匆忙翻找 ;偷窃	 [ˈraɪfl] 
stun	击晕;使大吃一惊	 [stʌn] 
payphone	公用电话	 [ˈpeɪfəʊn] 
flyer	传单;飞行物	 [ˈflaɪə(r)] 
inhale	吸气;〈非〉狼吞虎咽	 [ɪnˈheɪl] 
swell	膨胀;重要人士;非常棒的	 [swel] 
vomit	呕吐	[ˈvɒmɪt] 
syringe	注射器	 [sɪˈrɪndʒ]
prescription	处方药	 [prɪˈskrɪpʃn] 
depressor	抑压者	 [dɪˈpresə(r)] 
influenza	流感	 [ˌɪnfluˈenzə] 
bistoury	手术刀	 [bɪs'tʊrɪ] 
cart	运货马车;手推车;费力搬运	 [kɑ:t] 
recover	恢复	 [rɪˈkʌvə(r)] 
stanch	止（血）;使不漏;坚固的	 [stɔ:ntʃ] 
weep	流泪;（伤口）流血;渗出水汽	 [wi:p] 
locker	寄物柜	 [ˈlɒkə(r)] 
surgical	外科的;（服装）治疗用的	 [ˈsɜ:dʒɪkl] 
surgery	外科学;手术室;诊所;诊断时间	 [ˈsɜ:dʒəri] 
ceiling	天花板;最高限度	 [ˈsi:lɪŋ] 
instrument	仪器;乐器;手段;法律文件	[ˈɪnstrəmənt] 
scalpel	外科手术刀	 [ˈskælpəl] 
defibrillator	（电击）除颤器	 [di:ˈfɪbrɪleɪtə(r)] 
ventilator	通风设备;负责通风的人	 [ˈventɪleɪtə(r)] 
nasogastric	鼻胃管的	[neɪzəʊ'gæstrɪk]  
scrub	刷洗;取消（原有安排）;灌木丛	 [skrʌb] 
bandage	绷带	 [ˈbændɪdʒ] 
wool	羊毛	[wʊl] 
forceps	手术钳	 [ˈfɔ:seps] 
tourniquet	止血带	 [ˈtʊənɪkeɪ]
console	安慰;控制台;演奏台;悬臂	[kən'səʊl] 
identification	鉴定	[aɪˌdentɪfɪˈkeɪʃn] 
gown	长袍;大学的学生和教师	 [gaʊn] 
critical	关键的;爱挑剔的	 [ˈkrɪtɪkl] 
inpatient	住院病人	 [ˈɪnpeɪʃnt] 
oncologist	肿瘤学家	 [ɒŋ'kɒlədʒɪst] 
physician	医生	[fɪˈzɪʃn] 
surgeon	外科医生;[军]军医	 [ˈsɜ:dʒən]  
bedpan	（病人在床上用的）便盆	[ˈbedpæn] 
intravenous	静脉注射的	 [ˌɪntrəˈvi:nəs] 
vital	至关重要的;生气勃勃的	 [ˈvaɪtl] 
abort	流产;中止计划	 [əˈbɔ:t] 
endure	忍耐;持续	 [ɪnˈdjʊə(r)] 
exhale	发散出;呼气	 [eksˈheɪl] 
swoon	昏厥	 [swu:n] 
amniocentesis	羊膜腔穿刺术	 [ˌæmniəʊsenˈti:sɪs] 
cesarean	剖腹产	 [sɪˈzeəri:ən] 
dystocia	难产	 [dɪs'təʊʃɪə] 
fetal	胎儿的	 ['fi:tl] 
labor	劳动;劳工;分娩	 ['leɪbə(r)] 
anesthesia	麻醉	 [ˌænəsˈθi:ziə] 
miscarry	流产;失败	 [ˌmɪsˈkæri]
prenatal	胎儿期的	 [ˌpri:ˈneɪtl] 
diagnosis	诊断;结论	 [ˌdaɪəgˈnəʊsɪs] 
ultrasound	超声波	 [ˈʌltrəsaʊnd] 
umbilical	脐带的，母系的	 [ʌm'bɪlɪkəl] 
cord	用绳子捆绑;堆积（柴薪）	 [kɔ:d]
vaginal	阴道的;叶鞘的	 [və'dʒaɪnl] 
delivery	分娩;传送;交付	 [dɪˈlɪvəri] 
midwife	接生	 [ˈmɪdwaɪf] 
obstetrician	产科医师	[ˌɒbstəˈtrɪʃn] 
surrogate	代理;代替;代孕者	 [ˈsʌrəgət]
obstetric	产科的	[əb'stetrɪk] 
postpartum	产后的	 [ˌpəʊst'pɑ:təm]  
clasp	紧握;扣住;紧拥	 [klɑ:sp] 
resist	抵抗;反对;防腐剂	 [rɪˈzɪst] 
scratch	刮擦;打草稿用的	 [skrætʃ] 
nasal	鼻骨;鼻音字母，鼻音	 [ˈneɪzl]
congest	拥挤	 [kən'dʒest] 
congestion	阻塞;充血	 [kənˈdʒestʃən] 
nausea	恶心	 [ˈnɔ:ziə] 
sneeze	打喷嚏	 [sni:z]  
enterovirus	肠道病毒	[entərəʊ'vaɪərəs]  
mumps	腮腺炎	 [mʌmps] 
pinworm	蛲虫	 ['pɪnwɜ:m]  
polio	小儿麻痹症	 [ˈpəʊliəʊ] 
cholera	霍乱	 [ˈkɒlərə] 
encephalitis	脑炎	 [enˌsefəˈlaɪtəs] 
rubella	风疹	 [ru:ˈbelə] 
tetanus	破伤风	 [ˈtetənəs] 
whooping	发咳声的	 ['hu:pɪŋ] 
gaming	赌博	 [ˈgeɪmɪŋ] 
depress	压低;使沮丧;使跌价	 [dɪˈpres] 
inspire	激励;赋予灵感;吸入	 [ɪnˈspaɪə(r)] 
irritate	刺激;使发怒;使感到不适	 [ˈɪrɪteɪt] 
suicide	自杀	 [ˈsu:ɪsaɪd] 
arrogant	傲慢的	 [ˈærəgənt] 
disconsolate	惆怅	 [dɪsˈkɒnsələt] 
gloomy	黑暗的;令人沮丧的	 [ˈglu:mi] 
hysterical	癔病的;情绪异常激动的	 [hɪˈsterɪkl] 
immature	不成熟的;未完成的	 [ˌɪməˈtjʊə(r)] 
irritable	易怒的;过敏的	[ˈɪrɪtəbl] 
oblivious	健忘的	 [əˈblɪviəs] 
suspicious	可疑的	 [səˈspɪʃəs] 
psychologist	心理学家	 [saɪˈkɒlədʒɪst] 
clinical	临床的;诊所的;冷静的;简陋的	 [ˈklɪnɪkl] 
counseling	（对个人，社会以及心理等问题的）咨询服务	 ['kaʊnsəlɪŋ] 
psychiatrist	精神病医生	 [saɪˈkaɪətrɪst] 
psychotic	精神病的	 [saɪˈkɒtɪk] 
anxiety	焦虑	 [æŋˈzaɪəti] 
autism	自闭症	 [ˈɔ:tɪzəm]  
compulsive	强迫性的;极有趣的;令人着迷的	 [kəmˈpʌlsɪv] 
disorder	混乱	 [dɪsˈɔ:də(r)] 
frustration	挫折	 [frʌˈstreɪʃn] 
reshape	重塑	 [ˌri:ˈʃeɪp] 
rid	使摆脱，免除	 [rɪd] 
reduction	减少	 [rɪˈdʌkʃn] 
dermabrasion	皮肤磨削术	 [ˌdɜ:mə'breɪʒən] 
eyelid	眼皮	 [ˈaɪlɪd] 
enhancement	提高	 [ɪn'hɑ:nsmənt]  
liposuction	脂肪抽吸[术]	 [ˈlɪpəʊsʌkʃn] 
mole	鼹鼠;痣;间谍;防波堤	 [məʊl] 
removal	除去;搬迁	 [rɪˈmu:vl] 
augmentation	增大	 [ˌɔ:ɡmen'teɪʃn] 
scar	伤痕;断崖	 [skɑ:(r)] 
tummy	<非正>胃，肚子	 [ˈtʌmi] 
anesthetist	麻醉师	 [ə'nesθɪtɪst] 
esthetician	美学家	 [ˌesθə'tɪʃən] 
scalded	烫伤的	
botulinus	肉毒（杆）菌	 [ˌbɒtjʊ'laɪnəs] 
toxin	毒素	 [ˈtɒksɪn] 
collagen	[生化]胶原蛋白	 [ˈkɒlədʒən] 
hyaluronic	透明质酸的	 [haɪæ'lʊərɒnɪk] 
intense	热烈的	 [ɪnˈtens] 
pulsed	脉冲[振，动]的	 [pʊlst] 
silica	二氧化硅	 [ˈsɪlɪkə] 
blink	眨眼;闪烁	[blɪŋk] 
widen	（使）变宽	 [ˈwaɪdn] 
wink	使眼色;闪烁	 [wɪŋk] 
bloodshot	（眼睛）充血的	 [ˈblʌdʃɒt] 
blurry	模糊的;污脏的	 [ˈblɜ:ri] 
itchy	（使）发痒的;渴望旅行（或搬家、换工作等）	 [ˈɪtʃi] 
inflamed	发炎的，红肿的	 [ɪnˈfleɪmd]
lancinating	像枪刺般的	 ['lænsɪneɪtɪŋ]  
swollen	膨胀的;肿起的;涨满的	 [ˈswəʊlən] 
watery	水分多的	 [ˈwɔ:təri] 
cornea	眼角膜	 [ˈkɔ:niə]
optic	光学的;视觉的;镜片	 [ˈɒptɪk] 
nerve	神经;勇气;[植] 叶脉	 [nɜ:v] 
pupil	学生;[解]瞳孔;未成年人;[法]被监护人	 [ˈpju:pl] 
retina	视网膜	 [ˈretɪnə] 
lenses	透镜;眼睛中的水晶体	 [[lenz]] 
stereoscope	立体镜，立体照相镜	 ['sterɪəskəʊp] 
cavity	洞;蛀牙	 [ˈkævəti] 
brace	支撑;系紧;准备;振作起来	 [breɪs] 
denture	（一副）假牙	 ['dentʃə] 
interdental	牙齿之间的，舌头放在上下牙齿间发音的	 [ˌɪntɜ:'dentəl] 
canine	犬的;犬牙	 [ˈkeɪnaɪn] 
molar	臼齿的;磨碎的;质量的	 [ˈməʊlə(r)]  
mouthwash	漱口剂	 [ˈmaʊθwɒʃ] 
periodontal	牙齿周围的	[ˌperiəˈdɒntl] 
crown	王冠;（某物的）顶部;使圆满完成	 [kraʊn] 
dentin	象牙质（的东西），牙本质	['dentɪn]
dentition	齿系 （齿列、牙列等）	 [denˈtɪʃn] 
enamel	在…涂瓷漆;指甲油	 [ɪˈnæml] 
gums	牙龈;树胶	 ['ɡʌmz] 
pulp	牙髓;果肉;纸浆	 [pʌlp] 
registry	登记	 [ˈredʒɪstri] 
prohibit	禁止	 [prəˈhɪbɪt] 
condom	避孕套	 [ˈkɒndɒm] 
tonic	滋补品;<音>主音;<语>浊音	 [ˈtɒnɪk] 
ointment	药膏	 [ˈɔɪntmənt] 
pregnancy	怀孕;丰富;意义深长	 [ˈpregnənsi] 
strip	剥光;长条;（足球队员的）运动服	 [strɪp] 
tablet	药片;碑;便笺簿;小块	 [ˈtæblət] 
antibiotic	抗生素	 [ˌæntibaɪˈɒtɪk] 
contraceptive	避孕的	 [ˌkɒntrəˈseptɪv] 
pill	药丸;投票反对;抢劫	 [pɪl] 
gastric	胃的	 [ˈgæstrɪk] 
laxative	泻药	 [ˈlæksətɪv] 
bee	蜜蜂;（集工作、竞赛、娱乐为一体的）聚会	 [bi:] 
propolis	蜂胶	 ['prɒpəlɪs] 
calcium	<化>钙	 [ˈkælsiəm] 
glucosamine	氨基葡（萄）糖	 [glu:kəʊ'sæmi:n]  
vitamin	维生素	[ˈvɪtəmɪn]
coil	卷成一圈	 [kɔɪl] 
comb	梳子;鸡冠状的东西;蜂窝状的东西;涌起	 [kəʊm] 
dye	染色	 [daɪ] 
perm	烫发	 [pɜ:m] 
straighten	变直;整理;使…好转	 [ˈstreɪtn] 
bonnet	给…戴上帽子，给…装上罩	 [ˈbɒnɪt] 
hairdryer	吹风机	 [ˈheədraɪə(r)]  
curling	冰壶	 [ˈkɜ:lɪŋ] 
dandruff	头皮屑	 [ˈdændrʌf] 
ionic	离子的	 [aɪˈɒnɪk] 
trimmer	（树丛、花草、树篱的）修剪机 	 [ˈtrɪmə(r)] 
coiffeur	（为女子做头发的）理发师	 [kwɑ:'fɜ:] 
coiffeuse	（为女子做头发的）女理发师	[kwɑ:'fɜ:z]
hairdresser	理发师	 [ˈheədresə(r)] 
clay	黏土	 [kleɪ] 
hairspray	发胶	 [ˈheəspreɪ] 
diffuse	散开的;冗长的;	 [dɪˈfju:s] 
massage	按摩	 [ˈmæsɑ:ʒ] 
cosmetic	化妆品;装饰品	 [kɒzˈmetɪk] 
crystal	水晶;透明的	 [ˈkrɪstl] 
essential	必要的;基本的	[ɪˈsenʃl] 
hairpin	发夹	 [ˈheəpɪn] 
pumice	浮石;磨光	 [ˈpʌmɪs] 
callus	老茧	 [ˈkæləs]  
scented	有香味的	 [ˈsentɪd] 
wig	假发;法官帽;斥责	 [wɪg] 
aroma	芳香;气派	 [əˈrəʊmə] 
therapist	治疗专家	 [ˈθerəpɪst]
cosmetologist	美容师	 [ˌkɒzmɪ'tɒlədʒɪst] 
manicurist	美甲师	 [ˈmænɪkjʊərɪst]  
aromatherapy	芳香疗法	 [əˌrəʊməˈθerəpi] 
exfoliation	脱落物	
pedicure	修脚	 [ˈpedɪkjʊə(r)] 
horrible	可怕的	 [ˈhɒrəbl] 
inspirational	鼓舞人心的;给予灵感的	 [ˌɪnspəˈreɪʃənl]  
chick	小鸡;少妇;胆小的;雅致的	 [tʃɪk] 
horror	恐怖	 [ˈhɒrə(r)] 
tragedy	悲剧	 [ˈtrædʒədi] 
concession	让步;（尤指由政府或雇主给予的）特许权;租借地	 [kənˈseʃn] 
stub	树桩;铅笔头，烟蒂;票根	 [stʌb]
stunt	噱头;特技;发育不良的动植物	 [stʌnt] 
evacuation	撤离	 [ɪˌvækjʊ'eɪʃn] 
restricted	有受限制的;保密的	 [rɪˈstrɪktɪd] 
audio	声音的	 [ˈɔ:diəʊ]  
multimedia	多媒体的	 [ˌmʌltiˈmi:diə]  
bronze	青铜	 [brɒnz] 
colossus	巨人;大国;大企业	 [kəˈlɒsəs] 
curio	小件珍奇物品	 [ˈkjʊəriəʊ]  
explanatory	解释的	 [ɪkˈsplænətri] 
mummy	木乃伊;妈妈;干尸;干瘪的人	 [ˈmʌmi]  
specimen	样品	 [ˈspesɪmən] 
antiquarian	古文物研究者	 [ˌæntɪˈkweəriən]  
curator	（图书馆等的）馆长;监护人	 [kjʊəˈreɪtə(r)] 
admire	赞赏	 [ədˈmaɪə(r)] 
criticize	批评;评论	 [ˈkrɪtɪsaɪz] 
collage	拼贴	 [ˈkɒlɑ:ʒ] 
porcelain	瓷器，易碎的	 [ˈpɔ:səlɪn] 
pottery	陶器	 [ˈpɒtəri] 
carving	雕刻品	 [ˈkɑ:vɪŋ] 
cubism	立体派	 ['kju:bɪzəm] 
fauvism	野兽派	 ['fəʊvɪzəm] 
impressionism	印象派	 [ɪm'preʃənɪzəm]  
realism	现实主义	 [ˈri:əlɪzəm]  
surrealism	超现实主义	 [səˈri:əlɪzəm] 
colossal	巨大的	 [kəˈlɒsl] 
vivid	生动的	 [ˈvɪvɪd] 
acquire	获得	 [əˈkwaɪə(r)] 
refract	<物>（使）折射	 [rɪˈfrækt] 
acoustics	声学	 [əˈku:stɪks] 
atmospheric	大气的	 [ˌætməsˈferɪk] 
botany	植物学;精纺毛纱;细羊毛	 [ˈbɒtəni]
electronics	电子学,电子流行音乐	 [ɪˌlekˈtrɒnɪks] 
kinetics	动力学	 [kɪ'netɪks] 
mechanics	力学;机械学	 [mɪ'kænɪks] 
optics	光学	 [ˈɒptɪks] 
thermal	热的	 [ˈθɜ:ml] 
physics	物理学	 [ˈfɪzɪks] 
telescope	望远镜;（使某物）叠缩	 [ˈtelɪskəʊp] 
ivory	象牙	 [ˈaɪvəri] 
mineral	矿物	 [ˈmɪnərəl] 
circulation	血液循环;流通;发行量;（某段时间的）社交活动	 [ˌsɜ:kjəˈleɪʃn] 
periodical	期刊;周期的	 [ˌpɪəriˈɒdɪkl]
encyclopedia	百科全书	 [ɪnˌsaɪklə'pi:dɪə] 
postpone	延缓;把…放在次要地位	 [pəˈspəʊn] 
reissue	重新发行	 [ˌri:ˈɪʃu:]  
demagnetizer	去磁器	 [di:'mæɡnɪtaɪzər]  
catalog	目录	 ['kætəlɔ:g] 
crash	崩溃;暴跌;睡觉;应急的	[kræʃ] 
idle	空闲的;虚度	 [ˈaɪdl] 
indulge	纵容	 [ɪnˈdʌldʒ] 
lag	落后;给…加上外套;把…关进牢里	 [læg] 
surf	冲浪;（互联网上）冲浪	 [sɜ:f] 
mainframe	（大型电脑的）主机	 [ˈmeɪnfreɪm] 
dropout	辍学者	 [ˈdrɒpaʊt] 
browse	浏览;吃草	 [braʊz] 
forum	论坛;法庭	 [ˈfɔ:rəm] 
nonprofit	非营利的	 [ˌnɒn'prɒfɪt]
hacker	（电脑） 黑客;计算机迷	 [ˈhækə(r)] 
domain	领域;领土;[计]域名	 [dəˈmeɪn] 
hyperlink	超链接	 [ˈhaɪpəlɪŋk] 
portal	入口	 [ˈpɔ:tl] 
embed	把…嵌入	 [ɪm'bed] 
archive	档案文件	 [ˈɑ:kaɪv] 
fancy	设想;爱好;（构思者）奇特的;昂贵的	 [ˈfænsi] 
uninspired	无想像力的，无灵感的，枯燥的	 [ˌʌnɪnˈspaɪəd]  
guestbook	留言本	
verification	证实	 [ˌverɪfɪ'keɪʃn]  
attach	附上;（有时不受欢迎或未受邀请而）参加;把…归因于	[əˈtætʃ] 
categorize	把…归类	 [ˈkætəgəraɪz] 
compose	构成;调解;创作（乐曲、诗歌等）	 [kəmˈpəʊz] 
carbon	碳;（一张）复写纸	 [ˈkɑ:bən]  
colleague	同事	 [ˈkɒli:g] 
customer	顾客	 [ˈkʌstəmə(r)] 
recipient	接受者;容器	 [rɪˈsɪpiənt] 
inbox	收信信箱	 [ˈɪnbɒks] 
spam	垃圾邮件;香火腿;午餐肉	 [spæm] 
trash	垃圾;断枝;拆毁	 [træʃ] 
applaud	夸赞，鼓掌	 [əˈplɔ:d] 
viola	中提琴	[viˈəʊlə] 
score	得分;20个	 [skɔ:(r)] 
revolving	循环的;旋转的	 [rɪˈvɒlvɪŋ] 
illumination	照明;阐明	 [ɪˌlu:mɪˈneɪʃn] 
alto	女低音	 [ˈæltəʊ] 
soprano	女高音	 [səˈprɑ:nəʊ] 
tenor	男高音	 [ˈtenə(r)] 
mezzanine	（尤指介于一层与二层之间的）中层楼，（戏院中的）包厢	 [ˈmezəni:n]  
proscenium	舞台	 [prəˈsi:niəm]  
bounce	跳，反弹;急促地动;退票	 [baʊns] 
choreograph	编舞	 [ˈkɒriəgrɑ:f] 
glide	滑行;消逝	 [glaɪd] 
usher	引座员	 [ˈʌʃə(r)]
spotting	测定点位	 ['spɒtɪŋ] 
incredible	难以置信的	 [ɪnˈkredəbl] 
spectacular	壮观的	 [spekˈtækjələ(r)] 
encore	再来一个！	 [ˈɒŋkɔ:(r)] 
bassist	低音歌手，低音乐器的演奏者	 [ˈbeɪsɪst] 
guitarist	吉他弹奏者	 [gɪˈtɑ:rɪst] 
choir	教堂的唱诗班	 [ˈkwaɪə(r)] 
greenroom	演员休息室	 ['gri:nrʊm] 
venture	冒险	 [ˈventʃə(r)] 
wager	赌金;担保	 [ˈweɪdʒə(r)] 
blackjack	以棒打;胁迫;扑克牌的二十一点	 [ˈblækdʒæk] 
crap	掷骰子;拉屎;〈俚〉休息	 [kræp] 
poker	扑克;烙制	 [ˈpəʊkə(r)] 
tournament	锦标赛	 [ˈtʊənəmənt]  
roulette	轮盘赌	 [ru:ˈlet] 
concert	音乐会;协调一致行动	 [ˈkɒnsət] 
jackpot	头奖	[ˈdʒækpɒt] 
neon	霓虹灯	 [ˈni:ɒn] 
dealer	经销商;庄家	 [ˈdi:lə(r)] 
accompany	陪伴;附加;为…伴奏	 [əˈkʌmpəni] 
buffet	自助餐;火车饮食柜台;车站快餐部;将…推来搡去	 [ˈbʊfeɪ] 
hallway	走廊	 [ˈhɔ:lweɪ] 
lobby	休息室;大厅;对…进行游说	 [ˈlɒbi] 
buddy	好友	 [ˈbʌdi] 
companion	同伴;（用于书名）指南	 [kəmˈpæniən] 
drunken	酒醉的	 [ˈdrʌŋkən] 
disco	迪斯科舞厅	 [ˈdɪskəʊ] 
bucket	水桶	 [ˈbʌkɪt] 
accost	跟…搭讪;（乞丐等）上前向…乞讨	 [əˈkɒst] 
carouse	狂饮的宴会	 [kəˈraʊz] 
chill	（使）变冷	 [tʃɪl] 
groove	沟;极其满意	 [gru:v] 
stagger	蹒跚;动摇;犹豫	 [ˈstægə(r)] 
uncork	拔去塞子	 [ˌʌnˈkɔ:k] 
stein	陶质（或玻璃）啤酒杯	 [staɪn] 
pool	水池;合伙经营;采（煤等）	 [pu:l] 
alcoholic	酒精的	 [ˌælkəˈhɒlɪk] 
bartender	酒保	 [ˈbɑ:tendə(r)]
cocktail	鸡尾酒;混合物;餐前开胃菜;（女服）在半正式场合穿的	 [ˈkɒkteɪl] 
romance	恋爱;爱情小说	 [rəʊˈmæns] 
thriller	恐怖小说;（电影）惊悚片	 [ˈθrɪlə(r)] 
award	奖品;（仲裁人、公断人的）裁定	 [əˈwɔ:d] 
cliche	陈词滥调	 ['kli:ʃeɪ] 
rated	定价的	 ['reɪtɪd] 
facility	设备;能力	 [fəˈsɪləti] 
alternative	替代的	 [ɔ:lˈtɜ:nətɪv] 
ballad	民谣	 [ˈbæləd] 
blues	蓝调;忧郁;	 [blu:z] 
folk	家属,民族,民间音乐,民间的	 [fəʊk] 
hip	臀部;屋脊;时髦的;使知晓	 [hɪp] 
gramophone	留声机	 [ˈgræməfəʊn] 
audition	听力;让…试唱	 [ɔ:ˈdɪʃn] 
concierge	看门人	 [ˈkɒnsieəʒ] 
reception	接待处	 [rɪˈsepʃn] 
bellhop	做杂役的男侍者	 [ˈbelhɒp] 
registration	登记，注册	 [ˌredʒɪˈstreɪʃn] 
balcony	阳台;包厢	 [ˈbælkəni] 
bathrobe	浴袍	 [ˈbɑ:θrəʊb] 
adequate	足够的	 [ˈædɪkwət] 
comfy	舒服的	 [ˈkʌmfi] 
suite	（房间，器具等）一套	 [swi:t]  
triple	三倍的，三方的	 [ˈtrɪpl] 
pajamas	睡衣裤	 [pə'dʒɑ:məz] 
toiletry	化妆品	 ['tɔɪlɪtrɪ] 
garment	服装	 [ˈgɑ:mənt] 
interlining	夹层	 [ˌɪntə'laɪnɪŋ] 
duffel	露营用具	 ['dʌfəl] 
dine	进餐	 [daɪn] 
dorm	宿舍	 [dɔ:m]  
linen	亚麻布;家庭日用织品	 [ˈlɪnɪn] 
unisex	（指服饰等）不分男女的	 [ˈju:nɪseks] 
budget	预算	 [ˈbʌdʒɪt] 
staff	职员的	 [stɑ:f] 
rental	租费	 [ˈrentl] 
transportation	运输	 [ˌtrænspɔ:ˈteɪʃn] 
herbivore	食草动物	 [ˈhɜ:bɪvɔ:(r)] 
camel	骆驼	 [ˈkæml] 
deer	鹿	 [dɪə(r)] 
hippo	河马	 [ˈhɪpəʊ] 
kangaroo	袋鼠	 [ˌkæŋgəˈru:] 
koala	考拉	 [kəʊˈɑ:lə]  
rhino	犀牛	 [ˈraɪnəʊ] 
carnivore	食肉动物，食虫植物	 [ˈkɑ:nɪvɔ:(r)] 
cheetah	非洲猎豹	 [ˈtʃi:tə] 
coyote	草原狼	 [kaɪˈəʊti] 
jaguar	美洲虎	 [ˈdʒægjuə(r)] 
leopard	豹	 [ˈlepəd]  
raccoon	浣熊	 [rəˈku:n]
skunk	臭鼬	 [skʌŋk] 
weasel	鼬鼠，黄鼠狼;狡猾的人;躲闪（承诺、责任等）	 [ˈwi:zl] 
veterinarian	兽医	 [ˌvetərɪˈneəriən] 
entrance	入口;使入迷	 [ˈentrəns] 
amphibian	两栖动物;两栖（类）的;具有双重性格的	 [æmˈfɪbiən] 
otter	（水）獭	 [ˈɒtə(r)] 
nocturnal	夜间的	 [nɒkˈtɜ:nl] 
penguin	企鹅	 [ˈpeŋgwɪn] 
reptile	爬行动物;卑鄙的人	 [ˈreptaɪl] 
chameleon	变色龙	[kəˈmi:liən]  
crocodile	鳄鱼	 [ˈkrɒkədaɪl]  
cobra	眼镜蛇	 [ˈkəʊbrə] 
lizard	蜥蜴	 [ˈlɪzəd] 
viper	毒蛇;阴险恶毒的人	 [ˈvaɪpə(r)] 
ostrich	鸵鸟;逃避现实的人	 [ˈɒstrɪtʃ] 
peacock	孔雀;爱虚荣的人	 [ˈpi:kɒk] 
insect	昆虫;卑鄙的人	 [ˈɪnsekt] 
beetle	甲壳虫;大槌	 [ˈbi:tl] 
cicada	蝉	 [sɪˈkɑ:də] 
cricket	蟋蟀	 [ˈkrɪkɪt] 
dragonfly	蜻蜓	 [ˈdrægənflaɪ] 
ladybug	瓢虫	 ['leɪdɪbʌɡ] 
longhorn	长角牛，音乐探测器	 [ˈlɔŋhɔ:n]  
mantis	螳螂	 [ˈmæntɪs] 
scorpion	蝎子	 [ˈskɔ:piən] 
stag	成年牡鹿;阉过的雄畜[牛，猪];全是男人（集会等）的	 [stæg] 
fierce	凶猛的	[fɪəs]
rare	罕见的	 [reə(r)] 
tame	驯服的;平淡的	 [teɪm] 
toxic	有毒的	 [ˈtɒksɪk] 
regulate	调整	 [ˈregjuleɪt] 
caterpillar	毛虫;履带	 [ˈkætəpɪlə(r)] 
earthworm	蚯蚓	 [ˈɜ:θwɜ:m] 
pond	池塘	 [pɒnd] 
lotus	莲花	 [ˈləʊtəs]  
snail	蜗牛;慢性子	 [sneɪl] 
fragrance	芳香	[ˈfreɪgrəns] 
phytoncide	植物杀菌素	 ['faɪtənsaɪd] 
respiration	呼吸	 [ˌrespəˈreɪʃn] 
scent	嗅觉;气味	 [sent] 
vegetation	植物	 [ˌvedʒəˈteɪʃn] 
lawnmower	剪草机	 [ˈlɔ:nməʊə(r)] 
regulator	调整器	[ˈregjuleɪtə(r)] 
wheelbarrow	独轮手推车	 [ˈwi:lbærəʊ]  
thrill	使激动;使颤动	 [θrɪl] 
carousel	旋转木马	 [ˌkærəˈsel] 
haunted	闹鬼的;忧心忡忡的	 [ˈhɔ:ntɪd] 
merry	愉快的;甜樱桃	 [ˈmeri] 
pirate	海盗;侵害版权者	 [ˈpaɪrət]  
fearful	胆怯的	 [ˈfɪəfl] 
nervous	焦虑的	 [ˈnɜ:vəs]  
terrified	很害怕的	 [ˈterɪfaɪd] 
circus	马戏团;圆形广场	 [ˈsɜ:kəs] 
tightrope	钢丝;极其危险的道路或处境	 [ˈtaɪtrəʊp]  
trampoline	蹦床	 [ˈtræmpəli:n]  
trapeze	高空秋千，吊架	 [trəˈpi:z] 
unicycle	单轮脚踏车	 [ˈju:nɪsaɪkl] 
aerobatics	特技飞行	 [ˌeərəˈbætɪks] 
pyramid	金字塔;渐增	 [ˈpɪrəmɪd] 
puppetry	木偶，傀儡	 [ˈpʌpɪtri] 
springboard	跳板	 [ˈsprɪŋbɔ:d] 
stilts	高跷，支柱	 [stɪlt] 
bench	长凳;工作台;法官	 [bentʃ] 
bush	灌木;浓密（或茂密）地生长	 [bʊʃ] 
fishpond	养鱼塘	 ['fɪʃpɒnd] 
pavilion	亭;临时建筑物;大型文体馆;看台	 [pəˈvɪliən]
frisbee	飞盘	 ['frɪzbɪ] 
skating	溜冰;身处险境	 [ˈskeɪtɪŋ] 
rink	溜冰场	 [rɪŋk] 
tire	使…疲惫;使…厌烦;轮胎;头饰	 [ˈtaɪə(r)] 
babysitter	保姆	 [ˈbeɪbisɪtə(r)] 
laborer	体力劳动者	 ['leɪbərə]  
jogger	慢跑锻炼者	 [ˈdʒɒgə(r)]  
explorer	探险家;探测器	 [ɪkˈsplɔ:rə(r)] 
paddle	桨;洗衣板;乒乓球拍 	 [ˈpædl] 
trek	长途跋涉	 [trek]  
kindling	引火柴	 [ˈkɪndlɪŋ] 
jackknife	折叠刀	 [ˈdʒæknaɪf] 
provision	条款;供应;预备	 [prəˈvɪʒn] 
bedroll	铺盖	 [ˈbedrəʊl] 
campfire	篝火	 [ˈkæmpfaɪə(r)] 
mosquito	蚊子	 [məˈski:təʊ] 
cave	洞穴;（使）塌陷;屈服	 [keɪv] 
kayak	皮艇	 [ˈkaɪæk]  
ravine	峡谷	 [rəˈvi:n] 
trail	跟踪;（在比赛等中）输;足迹 ;小径	 [treɪl] 
avalanche	雪崩	 [ˈævəlɑ:nʃ] 
blizzard	暴风雪;大量	 [ˈblɪzəd] 
chairlift	（运送滑雪者或游客上，下上的）升降机	 [ˈtʃeəlɪft] 
course	课程;航线;快跑	 [kɔ:s] 
slope	斜坡	 [sləʊp]  
snowplow	扫雪机	 ['snəʊˌplaʊ]
snowstorm	暴风雪	 [ˈsnəʊstɔ:m] 
muff	套袖;弄糟	 [mʌf] 
sleigh	雪橇	 [sleɪ] 
sled	雪橇	 [sled] 
rotate	（使某物）旋转，轮换	 [rəʊˈteɪt] 
mogul	有权势的人	 [ˈməʊgl] 
slalom	障碍滑雪	 [ˈslɑ:ləm]  
suntan	晒黑	 [ˈsʌntæn] 
bikini	比基尼式游泳衣	 [bɪˈki:ni]  
dune	沙丘	 [dju:n] 
buggy	婴儿车;小机动车	 [ˈbʌgi] 
hermit	隐士;小甜饼	 [ˈhɜ:mɪt]  
sunscreen	防晒霜	 [ˈsʌnskri:n] 
parasailing	帆伞运动	 [ˈpærəseɪlɪŋ] 
sandcastle	沙堡	 [ˈsændkɑ:sl] 
surfboard	冲浪板	 [ˈsɜ:fbɔ:d] 
babe	婴儿	 [beɪb] 
lifeguard	救生员	 [ˈlaɪfgɑ:d] 
conquer	征服	 [ˈkɒŋkə(r)] 
glorify	赞美	 [ˈglɔ:rɪfaɪ] 
struggle	奋斗	 [ˈstrʌgl]  
uphold	赞成;支撑	 [ʌpˈhəʊld]  
aquatic	水生动植物;水上运动	 [əˈkwætɪk] 
archery	箭术	 [ˈɑ:tʃəri] 
athletics	田径运动;体育（课）	 [æθˈletɪks] 
badminton	羽毛球	 [ˈbædmɪntən] 
canoe	独木舟	 [kəˈnu:] 
equestrian	骑马的	[ɪˈkwestriən] 
fencing	剑术;围墙	 [ˈfensɪŋ] 
gymnastics	体操	 [dʒɪmˈnæstɪks]  
weightlifting	举重	[ˈweɪtlɪftɪŋ] 
wrestling	摔跤	 [ˈreslɪŋ] 
ceremony	典礼;礼仪	 [ˈserəməni]
mascot	吉祥物	 [ˈmæskət] 
medal	奖牌;纪念章	 [ˈmedl] 
bearer	持票人;送信人;搬运工人	 [ˈbeərə(r)] 
predecessor	前任	 [ˈpri:dɪsesə(r)] 
accelerate	加速	 [əkˈseləreɪt] 
caution	警告;小心	 [ˈkɔ:ʃn] 
disqualify	取消…的资格	 [dɪsˈkwɒlɪfaɪ] 
overtake	压倒;追上;（不愉快的事）突然降临	 [ˌəʊvəˈteɪk] 
pit	井;煤矿;麻子;（赛车道旁的）修理加油站	 [pɪt] 
speedway	赛车跑道	 [ˈspi:dweɪ] 
chicane	赛车道上的障碍物;诈骗	 [ʃɪˈkeɪn] 
circuit	巡回;电路	 [ˈsɜ:kɪt]
curb	遏制;勒马绳;（人行道的）镶边	 [kɜ:b] 
curve	曲线状物	 [kɜ:v]  
race	人种;比赛;快速移动;剧烈跳动	 [reɪs] 
grid	格子	 [grɪd] 
breathtaking	惊险的;非常激动人心的	 [ˈbreθteɪkɪŋ] 
hazardous	冒险的	 [ˈhæzədəs]  
thrilling	令人兴奋的;毛骨悚然的	 [ˈθrɪlɪŋ]  
putt	（高尔夫球）轻击	 [pʌt] 
ace	发球得分;王牌驾驶员;佼佼者	 [eɪs] 
birdie	小鸟儿;小鸟球（高尔夫中指某洞的杆数低于标准杆一杆）	 [ˈbɜ:di] 
bogey	妖怪;可怕的东西	 [ˈbəʊgi]  
eagle	鹰;[高]比标准杆少两杆的分数	 [ˈi:gl] 
par	标准;[体]标准杆数	 [pɑ:(r)] 
yardage	尺码	 [ˈjɑ:dɪdʒ] 
bunker	沙坑;地堡;燃料库;使陷入困境	 [ˈbʌŋkə(r)] 
fairway	航路	 [ˈfeəweɪ] 
flagstick	旗杆	 ['flægstɪk] 
tee	准备发球;（高尔夫球比赛）开赛;使生气	
hazard	冒险的事	 [ˈhæzəd] 
gear	齿轮;衣服	 [gɪə(r)] 
wristlet	腕饰	 ['rɪstlɪt] 
racket	（网球等）球拍;吵闹;勒索 	 [ˈrækɪt] 
racquet	球拍	 [ˈrækɪt] 
alternate	轮流的	 [ɔ:lˈtɜ:nət] 
deuce	平手	 [dju:s]
grand	宏伟的;重要的;一千美元;大钢琴	 [grænd] 
clubhouse	俱乐部;运动员更衣室	 [ˈklʌbhaʊs] 
court	宫廷;法院;院子;网球场;追求;求爱	[kɔ:t] 
sideline	兼职;（球场等的）边线;局外人的观点;使退出	 [ˈsaɪdlaɪn] 
instructor	指导者	 [ɪnˈstrʌktə(r)] 
linesman	巡边员;边线裁判员	 [ˈlaɪnzmən] 
dribble	运球;口水;细滴	 [ˈdrɪbl] 
dunk	将（食物）浸入液体;扣篮	[dʌŋk]
cheerleader	啦啦队队长;（强有力的）支持者	 [ˈtʃɪəli:də(r)] 
offense	进攻;（球队的）前锋	 [əˈfens] 
foul	犯规的	 [faʊl] 
hoop	铁环;呼呼声	 [hu:p] 
bat	蝙蝠;球棒;球拍;白话	 [bæt] 
rotation	旋转;轮流	 [rəʊˈteɪʃn] 
bullpen	<美>牛栏，<口>大房间（尤指候审犯人用的），候补队员区	 [ˈbʊlpen] 
dugout	独木舟;防空洞	 [ˈdʌgaʊt] 
infield	（棒球场地的）内场	 [ˈɪnfi:ld]   
mound	土堆	[maʊnd] 
outfield	（板球及棒球）外场	 [ˈaʊtfi:ld] 
robin	知更鸟	[ˈrɒbɪn] 
semi	半独立式住宅; (体育比赛中的)半决赛 	 [ˈsemi] 
injury	受伤处	 [ˈɪndʒəri] 
offside	<体>越位的	 [ˌɒfˈsaɪd] 
touchline	边线	 [ˈtʌtʃlaɪn]  
striker	罢工者打手;（足球的）前锋;锤;报点时钟	[ˈstraɪkə(r)] 
leap	跳;冲动的行动	 [li:p] 
spike	长钉;细高跟;加烈酒于;打乱某人的计划	 [spaɪk] 
alternation	轮流	 [ˌɔ:ltə'neɪʃn] 
combination	结合	 [ˌkɒmbɪˈneɪʃn] 
gesture	手势	 [ˈdʒestʃə(r)] 
collide	相撞;冲突	 [kəˈlaɪd] 
punt	平底船;踢悬空球;下赌注者	 [pʌnt] 
scrimmage	混战，并列争球	 [ˈskrɪmɪdʒ] 
illegal	不合法的	 [ɪˈli:gl]
discus	铁饼	 [ˈdɪskəs] 
javelin	标枪	 [ˈdʒævlɪn]  
triathlon	三项全能运动	 [traɪˈæθlən] 
parallel	平行的	[ˈpærəlel] 
sweat	流汗;做苦工;焦虑	 [swet] 
inning	一局	 [ˈɪnɪŋ] 
pinsetter	（滚球）球童	 ['pɪnˌsetə] 
hill	小山	 [hɪl] 
choke	窒息;哽咽;阻塞	 [tʃəʊk] 
combat	搏斗;比赛;防止;减轻	 [ˈkɒmbæt] 
prick	刺	 [prɪk] 
sidekick	好友;助手	 [ˈsaɪdkɪk]
uppercut	曲臂挥拳向上直击	 [ˈʌpəkʌt] 
judo	柔道	 [ˈdʒu:dəʊ] 
karate	空手道	 [kəˈrɑ:ti] 
taekwondo	跆拳道	 [taɪ'kɒndəʊ] 
profound	意义深远的;深渊	 [prəˈfaʊnd] 
technical	技术（性）的	 [ˈteknɪkl] 
violent	暴力的;感情强烈的;颜色强烈的	 [ˈvaɪələnt] 
armor	装甲;保障	 ['ɑ:mə] 
boxing	拳击;装箱;做箱（或盒）的材料	 [ˈbɒksɪŋ] 
nunchakus	双节棍	 [nənˌtʃəkʊs] 
sword	剑;武力;兵权	 [sɔ:d] 
whirl	旋转;急走;头晕眼花	 [wɜ:l] 
hockey	曲棍球;冰球	[ˈhɒki]  
skateboarding	滑板运动	 ['skeɪtbɔ:dɪŋ] 
ledge	暗礁;矿脉	 [ledʒ] 
obstacle	障碍（物）	 [ˈɒbstəkl] 
ramp	斜坡;敲诈	[ræmp] 
trick	恶作剧;戏法;骗局	 [trɪk]
blade	桨叶;刀片;叶片	 [bleɪd] 
strengthen	加强;激励	 [ˈstreŋθn] 
elliptical	椭圆的;省略的	 [ɪˈlɪptɪkl]  
recumbent	躺着的;斜靠的	 [rɪˈkʌmbənt] 
rowing	划（船）	 [ˈrəʊɪŋ] 
stationary	不动的人;驻军;固定物	 [ˈsteɪʃənri] 
dumbbell	哑铃;傻瓜	 ['dʌmbel] 
kickboxing	跆拳道	 ['kɪkˌbɒksɪŋ] 
yoga	瑜伽	 [ˈjəʊgə] 
dietitian	营养学家	 [ˌdaɪəˈtɪʃn] 
kickboard	踢水板	 ['kɪkbɔ:d] 
megaphone	扩音器	 [ˈmegəfəʊn] 
stroke	中风;击球;划水动作;划掉;轻抚	 [strəʊk] 
backstroke	仰泳	 [ˈbækstrəʊk] 
breaststroke	蛙泳	 [ˈbreststrəʊk] 
swimsuit	（女式）游泳衣	 [ˈswɪmsu:t] 
hydrotherapy	水疗法	 [ˌhaɪdrəʊˈθerəpi] 
plunge	全心投入;陷入	 [plʌndʒ] 
flutter	振翼;（旗帜）飘扬;颤振;紧张	 [ˈflʌtə(r)] 
hottie	热水瓶	 ['hɒtɪ] 
landlubber	旱鸭子	 [ˈlændlʌbə(r)] 
exploit	剥削;开采;功绩	 [ɪkˈsplɔɪt] 
pasture	牧场;放牧	 [ˈpɑ:stʃə(r)] 
oasis	（沙漠中的）绿洲	 [əʊˈeɪsɪs] 
jackal	豺狼	 [ˈdʒækl]  
rattlesnake	响尾蛇	 [ˈrætlsneɪk]
fatal	致命的	 [ˈfeɪtl] 
scarce	缺乏的;几乎不	 [skeəs] 
caravan	（可供居住的）拖车;旅行队（如商队）	 [ˈkærəvæn] 
desertification	沙漠化	 [dɪˌzɜ:tɪfɪˈkeɪʃn]  
hunt	打猎	 [hʌnt] 
row	划船;使…成排;争吵	 [rəʊ] 
convection	对流	 [kənˈvekʃn] 
evergreen	常绿植物	 [ˈevəgri:n]
fern	蕨类植物	 [fɜ:n]  
piranha	食人鱼	[pɪˈrɑ:nə] 
python	蟒蛇	[ˈpaɪθən] 
shotgun	猎枪	 [ˈʃɒtgʌn] 
frog	青蛙	 [frɒg] 
tribe	部落	 [traɪb] 
vine	藤	 [vaɪn] 
endangered	濒危的	 [ɪn'deɪndʒəd] 
greedy	贪婪的	 [ˈgri:di] 
humid	潮湿的	 [ˈhju:mɪd] 
aboriginal	土著的	 [ˌæbəˈrɪdʒənl] 
adventurer	探险家;投机商人	 [ədˈventʃərə(r)] 
botanist	植物学家	 [ˈbɒtənɪst] 
lumberman	伐木工人	 ['lʌmbəmən] 
poacher	偷猎者;煮蛋用的锅	 [ˈpəʊtʃə(r)] 
inhabit	居住	 [ɪnˈhæbɪt] 
ski	滑雪	 [ski:] 
arctic	北极的	 ['ɑ:ktɪk] 
char	烧焦;做杂役女佣	 [tʃɑ:(r)] 
aurora	北极光;曙光	 [ɔ:'rɔ:rə] 
glacier	冰川	[ˈglæsiə(r)] 
moose	驼鹿	 [mu:s] 
observatory	天文台	 [əbˈzɜ:vətri]
sledge	大锤;雪橇	 [sledʒ] 
ecologist	生态学者	 [iˈkɒlədʒɪst] 
inuit	因纽特人的	 [ˈɪnjuɪt] 
meteorologist	气象学家	 [ˌmi:tiəˈrɒlədʒɪst]  
zoologist	动物学家	 [zəʊˈɒlədʒɪst]  
encamp	扎营	 [ɪnˈkæmp] 
extinct	灭绝的	 [ɪkˈstɪŋkt] 
hardy	强壮的人;耐旱植物	 [ˈhɑ:di] 
explode	爆炸	 [ɪkˈspləʊd] 
orbit	轨道;眼眶;势力范围;（人生的）旅程	 [ˈɔ:bɪt] 
atmosphere	气氛;大气层	 [ˈætməsfɪə(r)] 
comet	彗星	 [ˈkɒmɪt] 
constellation	星座;一系列	[ˌkɒnstəˈleɪʃn]
dwarf	侏儒	[dwɔ:f] 
gravity	重力;重要性;庄重	 [ˈgrævəti] 
meteoroid	流星体	 ['mi:tjərɔɪd] 
spaceship	宇宙飞船	 [ˈspeɪsʃɪp]
sunspot	太阳黑子;雀斑	 [ˈsʌnspɒt]  
astrophysicist	天体物理学家	 [ˌæstrəʊ'fɪzɪsɪst] 
theoretical	理论的	 [ˌθɪəˈretɪkl] 
asteroid	小行星	[ˈæstərɔɪd] 
ecliptic	黄道的，日（或月）食的	 [ɪ'klɪptɪk] 
mercury	[化]汞;[天]水星	 [ˈmɜ:kjəri] 
Neptune	海王星	[ˈneptju:n] 
Uranus	天王星	 [ˈjʊərənəs] 
dove	鸽;纯洁的人	 [dʌv]
sparrow	麻雀;〈美〉个子小的人	 [ˈspærəʊ] 
glider	滑翔机	 [ˈglaɪdə(r)]  
missile	导弹;投射物	 [ˈmɪsaɪl] 
parachute	降落伞	 [ˈpærəʃu:t] 
thunder	雷声;隆隆的响声	 [ˈθʌndə(r)] 
unceasing	不停的	 [ʌnˈsi:sɪŋ] 
ozonosphere	臭氧层	 [əʊ'zəʊnəˌsfɪə] 
stratosphere	平流层;最上层	 [ˈstrætəsfɪə(r)] 
troposphere	对流层	 [ˈtrɒpəsfɪə(r)] 
bailey	（城堡的）外墙	 [ˈbeɪli] 
corridor	走廊	[ˈkɒrɪdɔ:(r)] 
drawbridge	吊桥	 [ˈdrɔ:brɪdʒ] 
fireplace	壁炉	 [ˈfaɪəpleɪs] 
moat	壕沟，护城河	 [məʊt]   
staircase	楼梯	 [ˈsteəkeɪs] 
passage	（文章的）一段;通道;旅程	 [ˈpæsɪdʒ] 
imposing	印象深刻的;壮观的	[ɪmˈpəʊzɪŋ] 
dethrone	废黜	 [ˌdi:ˈθrəʊn] 
mural	壁画;墙壁的	 [ˈmjʊərəl] 
royal	王室的;高贵的	[ˈrɔɪəl] 
mantle	斗篷;幕;覆盖	 [ˈmæntl] 
scepter	（尤指象征君主权位的）权杖;王权	 ['septə] 
throne	王位	 [θrəʊn] 
aristocracy	贵族	 [ˌærɪˈstɒkrəsi] 
concubine	妾	 [ˈkɒŋkjubaɪn] 
jester	（昔日为统治者说笑逗乐的）弄臣	 [ˈdʒestə(r)] 
cruel	残酷的	[kru:əl] 
sumptuous	豪华的;腆	 [ˈsʌmptʃuəs] 
authenticate	鉴定，使生效	[ɔ:ˈθentɪkeɪt]
decay	（使）腐烂	 [dɪˈkeɪ] 
mend	修补	 [mend] 
rob	抢劫	[rɒb] 
coffin	棺材	 [ˈkɒfɪn] 
curse	诅咒;逐出教门	 [kɜ:s] 
mortuary	太平间	 [ˈmɔ:tʃəri] 
inscription	碑文;（作者）题词	[ɪnˈskrɪpʃn]
stele	石碑，匾额	 ['sti:lɪ] 
archaeologist	考古学家	 [ˌɑ:kiˈɒlədʒɪst] 
craftsman	工匠	 [ˈkrɑ:ftsmən] 
historian	历史学家	 [hɪˈstɔ:riən] 
paleontologist	古生物学者	 [pælɪɒn'tɒlədʒɪst]  
raider	袭击者；抢劫者 	 [ˈreɪdə(r)] 
scholar	学者;奖学金获得者	 [ˈskɒlə(r)]
cautiously	谨慎地	 ['kɔ:ʃəslɪ] 
damaged	被损坏的	 ['dæmɪdʒd] 
elope	私奔	 [ɪˈləʊp]  
officiate	行使（职务）;主持（宗教仪式）	 [əˈfɪʃieɪt] 
goblet	高脚酒杯	 [ˈgɒblət] 
tuxedo	燕尾服	[tʌkˈsi:dəʊ] 
veil	面纱;掩饰	 [veɪl] 
vow	誓言;郑重宣布	 [vaʊ] 
bachelor	学士;单身汉	 [ˈbætʃələ(r)] 
bridal	新婚的	 [ˈbraɪdl] 
bride	新娘	 [braɪd] 
catering	承办酒席	 [ˈkeɪtərɪŋ] 
dowry	嫁妆	 [ˈdaʊri] 
bridesmaid	伴娘	 [ˈbraɪdzmeɪd]  
groom	新郎;马夫;打扮	 [gru:m] 
officiant	主祭	[ə'fɪʃɪənt] 
cremate	火葬	 [krəˈmeɪt] 
embalm	保存（尸体）不腐;使不被遗忘	 [ɪmˈbɑ:m] 
entomb	埋葬	 [ɪnˈtu:m] 
mourn	哀悼	 [mɔ:n] 
pray	祈祷	 [preɪ] 
sob	呜咽（声）	 [sɒb] 
transport	运输;流放;使欣喜若狂	 [ˈtrænspɔ:t] 
wail	哀号	 [weɪl] 
ash	灰	[æʃ] 
columbarium	骨灰安置所	 [ˌkɒləm'berɪəm]  
pagoda	宝塔	 [pəˈgəʊdə] 
eulogy	颂词	 [ˈju:lədʒi] 
grave	坟墓;雕刻;铭记;沉重的;（颜色等）朴素的	 [ɡreɪv] 
hearse	灵车	 [hɜ:s] 
incense	香;激怒	 [ˈɪnsens] 
mourning	哀悼	 [ˈmɔ:nɪŋ]
prayer	祈祷文	 [preə(r)]  
requiem	（天主教）安魂弥撒仪式	 [ˈrekwiəm]  
tombstone	墓碑	 [ˈtu:mstəʊn] 
cremation	火葬	 [krəˈmeɪʃn] 
interment	埋葬	 [ɪnˈtɜ:mənt]
memorial	纪念碑	 [məˈmɔ:riəl] 
repast	就餐	 [rɪˈpɑ:st]
chant	咏唱	 [tʃɑ:nt] 
distant	遥远的;冷漠的;不太清晰的	 [ˈdɪstənt] 
mortician	殡仪业者	 [mɔ:ˈtɪʃn] 
pallbearer	抬棺者	['pɔ:lˌbeərə] 
priest	牧师	 [pri:st] 
Taoist	道家	 ['taʊɪst] 
confetti	（婚礼时撒在新娘新郎身上的）五彩纸屑	 [kənˈfeti]  
keg	小桶	 [keg] 
ornament	装饰	 [ˈɔ:nəmənt] 
streamer	（作装饰用的）彩色纸带	 [ˈstri:mə(r)] 
kegger	啤酒聚会	 ['keɡə] 
hen	母鸡	 [hen] 
housewarming	乔迁庆宴	 ['haʊzwɔ:mɪŋ] 
potluck	家常便饭	 [pɒtˈlʌk] 
partygoer	社交聚会常客	 ['pɑ:tɪˌgəʊə] 
prom	正式舞会，毕业舞会	 [prɒm]  
nominate	提名；指定（时间、日期、名称等）	 [ˈnɒmɪneɪt] 
televise	电视转播	 [ˈtelɪvaɪz] 
statuette	小雕像	 [ˌstætʃuˈet] 
limousine	豪华轿车	 [ˈlɪməzi:n] 
nominee	被提名者	[ˌnɒmɪˈni:] 
telecast	电视转播	 [ˈtelikɑ:st] 
informal	（语言） 非正式的	 [ɪnˈfɔ:ml] 
matronly	主妇似的	 [ˈmeɪtrənli] 
emcee	主持	 [emˈsi:] 
absolve	宣告…无罪	 [əbˈzɒlv] 
baptize	给…施洗礼;使经受考验	 [bæpˈtaɪz] 
donate	捐赠	[dəʊˈneɪt] 
kneel	跪	 [ni:l] 
preach	布道	 [pri:tʃ] 
reform	改革	 [rɪˈfɔ:m] 
worship	崇拜	 [ˈwɜ:ʃɪp] 
baptism	（基督教的）洗礼;严峻考验	[ˈbæptɪzəm] 
gospel	福音;真理	 [ˈgɒspl] 
hymn	赞美诗	 [hɪm] 
pew	教堂长椅	 [pju:] 
virgin	处女，童男;未使用的	 [ˈvɜ:dʒɪn] 
confessional	忏悔的;（教堂内的）告解室	 [kənˈfeʃənl] 
diocese	 (主教管辖的)教区 	 [ˈdaɪəsɪs]
narthex	教堂前厅	 ['nɑ:ˌθeks] 
nave	教堂正厅	 [neɪv] 
sanctuary	圣所;避难所	 [ˈsæŋktʃuəri] 
spire	塔尖;螺旋	 [ˈspaɪə(r)] 
bishop	（基督教某些教派管辖大教区的）主教	 [ˈbɪʃəp] 
Catholic	天主教的	 [ˈkæθlɪk] 
clergy	（尤指基督教堂内的）牧师	 [ˈklɜ:dʒi] 
missionary	传教士	 [ˈmɪʃənri] 
nun	修女，尼姑	 [nʌn] 
pastor	牧师	 [ˈpɑ:stə(r)] 
interpret	解释;口译	 [ɪnˈtɜ:prɪt] 
altar	祭坛	 [ˈɔ:ltə(r)] 
amulet	护身符	 [ˈæmjʊlət] 
Buddhist	佛教的	 ['bʊdɪst] 
divining	占卜	 [dɪ'vaɪnɪŋ] 
phrase	成语;<语>短语	 [freɪz] 
sacrifice	牺牲;献祭	 [ˈsækrɪfaɪs] 
exorcism	驱魔	 [ˈeksɔ:sɪzəm]  
pilgrimage	朝圣之旅	 [ˈpɪlgrɪmɪdʒ] 
puppet	木偶;傀儡	 [ˈpʌpɪt]  
monk	修道士，僧侣	 [mʌŋk] 
pilgrim	朝圣者	 [ˈpɪlgrɪm] 
worshiper	崇拜者	 ['wɜ:ʃɪpə] 
engulf	吞没	 [ɪnˈgʌlf] 
cannon	大炮;与…猛撞	 [ˈkænən] 
arson	纵火	 [ˈɑ:sn] 
negligence	疏忽	 [ˈneglɪdʒəns] 
oxidizer	氧化剂	 ['ɒksɪˌdaɪzə] 
arsonist	纵火犯	 [ˈɑ:sənɪst] 
bystander	旁观者	 [ˈbaɪstændə(r)] 
evacuee	被疏散者	 [ɪˌvækjuˈi:] 
paralyze	使瘫痪	 ['pærəlaɪz] 
airlift	空运	 [ˈeəlɪft] 
epicenter	<地>震中	 ['epɪsentə] 
hypocenter	（地震的）震源	 [ˌhaɪpəʊ'sentə] 
Richter	里氏	 [ˈriktə] 
seismic	地震的	 [ˈsaɪzmɪk] 
crust	地壳;外壳;面包皮	 [krʌst] 
boundary	分界线	[ˈbaʊndri] 
casualty	伤亡（人数）	 [ˈkæʒuəlti]  
landslide	[地]山崩;大胜利	 [ˈlændslaɪd]  
soil	泥土;国土;弄脏	 [sɔɪl] 
liquefaction	液化	 [ˌlɪkwɪ'fækʃən] 
tsunami	海啸	 [tsu:ˈnɑ:mi]  
seismologist	地震学家	[ˌsaɪzmə'lɒdʒɪst] 
dissipate	消散;浪费(金钱、时间或精力)	[ˈdɪsɪpeɪt] 
intensify	（使）增强	 [ɪnˈtensɪfaɪ] 
linger	徘徊;缓慢消失	[ˈlɪŋgə(r)] 
submerge	淹没	 [səbˈmɜ:dʒ] 
agricultural	农业的	 [ˌæɡrɪ'kʌltʃərəl] 
intensity	强度	 [ɪnˈtensəti] 
gust	一阵狂风;（感情）迸发	 [gʌst] 
torrential	 (大雨)倾盆的	 [təˈrenʃl] 
blackout	停电;新闻封锁;暂时失去知觉	 [ˈblækaʊt] 
intrusion	闯入;打扰	 [ɪnˈtru:ʒn] 
drift	漂流	 [drɪft]  
chaotic	混乱的	 [keɪˈɒtɪk] 
devastating	毁灭性的	[ˈdevəsteɪtɪŋ] 
severe	严峻的;严厉的	 [sɪˈvɪə(r)] 
erupt	爆发	 [ɪˈrʌpt] 
crater	弹坑;火山口;毁坏	 [ˈkreɪtə(r)] 
fissure	狭长裂缝或裂隙	 [ˈfɪʃə(r)]  
fumarole	（火山区的）喷气孔	 [ˈfju:mərəʊl] 
geothermal	地热的	 [ˌdʒi:əʊˈθɜ:ml] 
lava	熔岩	 [ˈlɑ:və] 
magma	岩浆	 [ˈmægmə] 
sulfur	硫磺	 ['sʌlfə]  
geologist	地质学家	 [dʒiˈɒlədʒɪst] 
geographer	地理学家	 [dʒiˈɒgrəfə(r)] 
fatigue	疲劳	 [fəˈti:g] 
compensation	补偿	 [ˌkɒmpenˈseɪʃn] 
cordon	警戒线	 [ˈkɔ:dn] 
settlement	结算;解决;（解决纷争的）协议;定居点;沉淀	 [ˈsetlmənt] 
motorist	汽车驾驶员	 [ˈməʊtərɪst] 
overheat	过热	[ˌəʊvəˈhi:t]
distribution	分配；分布 	 [ˌdɪstrɪˈbju:ʃn] 
alternating	交互的	 ['ɔ:ltəneɪtɪŋ] 
electricity	电	 [ɪˌlekˈtrɪsəti] 
consumption	消耗;肺病	 [kənˈsʌmpʃn] 
fuse	融合;保险丝;导火线	 [fju:z] 
insulator	绝缘	 [ˈɪnsjuleɪtə(r)] 
voltage	电压	 [ˈvəʊltɪdʒ] 
wattage	瓦特数	 [ˈwɒtɪdʒ] 
shock	使休克;使震惊;浓密的;蓬乱的	 [ʃɒk] 
inferno	地狱	 [ɪnˈfɜ:nəʊ] 
electrician	电工	 [ɪˌlekˈtrɪʃn] 
ascend	上升	 [əˈsend] 
descend	下降	 [dɪˈsend] 
encounter	遭遇;对决	 [ɪnˈkaʊntə(r)] 
distress	不幸	 [dɪˈstres] 
coma	昏迷;麻木	 [ˈkəʊmə] 
frostbite	冻伤,参加冬季帆船比赛	 [ˈfrɒstbaɪt] 
hypothermia	低体温	 [ˌhaɪpəˈθɜ:miə] 
hypoxia	氧不足	 [haɪˈpɒksiə] 
unconsciousness	无意识;失去知觉	 [ʌnˈkɒnʃəsnəs] 
confess	承认;坦白;	 [kənˈfes] 
detain	耽搁;拘留	 [dɪˈteɪn]
stab	刺	 [stæb] 
bloodstain	血迹	 [ˈblʌdsteɪn] 
caliber	口径;能力;	 ['kælɪbə] 
infrared	红外线的	 [ˌɪnfrəˈred] 
clue	线索;	 [klu:]
reward	报酬	 [rɪˈwɔ:d]
statute	法令	 [ˈstætʃu:t] 
abili	不在犯罪现场	
autopsy	验尸,（事后的）分析	 [ˈɔ:tɒpsi] 
fingerprint	指纹	[ˈfɪŋgəprɪnt]
residue	残渣	[ˈrezɪdju:] 
coroner	法医	 [ˈkɒrənə(r)] 
informant	提供消息的人	 [ɪnˈfɔ:mənt]
ambush	伏击	 [ˈæmbʊʃ] 
besiege	包围	 [bɪˈsi:dʒ] 
invade	侵入	 [ɪnˈveɪd] 
launch	发射	 [lɔ:ntʃ] 
rebel	叛逆者	 [ˈrebl] 
reconcile	使和解	 [ˈrekənsaɪl] 
raid	突然袭击;抢劫	[reɪd] 
atomic	原子的	 [əˈtɒmɪk]  
blitz	闪电战	 [blɪts] 
ditch	壕沟;摆脱;迫降	 [dɪtʃ] 
mine	我的;矿;地雷	 [maɪn]  
torpedo	鱼雷;破坏	 [tɔ:ˈpi:dəʊ] 
ally	联盟	[ˈælaɪ]  
ceasefire	（通常指永久性的）停火	 [ˈsi:sfaɪə(r)] 
tactic	战术;按顺序的	 [ˈtæktɪk] 
captive	被俘的	 [ˈkæptɪv] 
soldier	士兵;硬挺着	[ˈsəʊldʒə(r)] 
strongman	大力士	 [ˈstrɒŋmæn] 
aggregate	使聚集;总计达	 [ˈægrɪgət] 
scenarios	剧本;事态;脚本	 [sɪ'nɑ:ri:əʊz] 
kick off	（足球）中线开球;<口>（使）开始;<美，口>死	 [kik ɔf] 
constraint	约束	 [kənˈstreɪnt] 
legacy	遗产	 [ˈlegəsi] 
seminar	研讨会	[ˈsemɪnɑ:(r)]
fleet	船队;车队;港湾;飞逝	 [fli:t]
headquarter	设总部	 ['hed'kwɔ:tə] 
subsidiary	附属的	 [səbˈsɪdiəri] 
simultaneously	同时地	 [ˌsɪməl'teɪnɪəslɪ]
compliant 	遵从的;（与系列规则相）符合的	 [kəmˈplaɪənt] 
buzz	嗡嗡叫	 [bʌz] 
gen 	<英俚>情报	 [dʒen] 
marquee 	选取框;大帐篷	 [mɑ:ˈki:] 
leverage	举债经营;杠杆作用	 [ˈli:vərɪdʒ] 
seamless	无漏洞的	[ˈsi:mləs] 
perspective	透镜;观点;景色	 [pəˈspektɪv] 
cadence	节奏	 [ˈkeɪdns] 
Stockholm 	斯德哥尔摩（瑞典首都）	['stɒkhəʊm]
solicitation	恳求	 [səˌlɪsɪ'təɪʃn] 
jurisdiction 	管辖权	[ˌdʒʊərɪsˈdɪkʃn] 
volume	体积	 [ˈvɒlju:m] 
pane	窗格	 [peɪn] 
onslaught 	猛攻	 [ˈɒnslɔ:t]
manner	方式	 [ˈmænə(r)] 
lieu 	代替;场所	 [lu:] 
transition	过渡	[trænˈzɪʃn]
concurrent  	同时发生的	 [kənˈkʌrənt]
proactive	积极主动的	 [ˌprəʊˈæktɪv] 
Instrumentation 	仪器仪表;手段	 [ˌɪnstrəmenˈteɪʃn] 
telemetry	遥感勘测	 [təˈlemətri] 
assurance	保证	 [əˈʃʊərəns]
curriculum	课程	[kəˈrɪkjələm] 
resiliency	弹性	 [rɪ'zɪlɪənsɪ] 
velocity 	速度	 [vəˈlɒsəti] 
institute	开始;（教育、专业等）机构	 [ˈɪnstɪtju:t] 
quantum	量子	[ˈkwɒntəm] 
citation	引用	 [saɪˈteɪʃn] 
expertise	专家评价	 [ˌekspɜ:ˈti:z] 
academic	学术的	[ˌækəˈdemɪk] 
interdisciplinary	跨学科的	 [ˌɪntəˈdɪsəplɪnəri] 
discrete	离散的	 [dɪˈskri:t] 
regime	政体	 [reɪˈʒi:m] 
induced	感应的	 [ɪnd'ju:st]
vibration	振动	[vaɪˈbreɪʃn] 
renaissance	文艺复兴	[rɪˈneɪsns] 
cellular	细胞的	 [ˈseljələ(r)] 
cancerous	癌的	['kænsərəs] 
tumor	肿瘤	['tju:mə]
metastasis	转移	[məˈtæstəsɪs] 
regression	回归	 [rɪˈgreʃn] 
planar	平面的	[ˈpleɪnə(r)] 
algebras	代数	 ['ældʒɪbrəz] 
topological	拓扑	 [tɒpə'lɒdʒɪkəl] 
synthesis	合成	[ˈsɪnθəsɪs] 
ultrathin	超薄的	 ['ʌltrəθɪn]
merit 	值得	 [ˈmerɪt] 
fundamental	基本的	 [ˌfʌndəˈmentl] 
auspices	主持	 [ˈɔ:spɪsɪz] 
paradox	悖论	 [ˈpærədɒks] 
philosophical	哲学的	 [ˌfɪləˈsɒfɪkl]
intriguing	有趣的	[ɪnˈtri:gɪŋ]
frontier	边界	[ˈfrʌntɪə(r)] 
workshop	车间;专题讨论会	 [ˈwɜ:kʃɒp] 
faculty 	才能;全体教职员	[ˈfæklti] 
unify 	统一	 [ˈju:nɪfaɪ]
desperate	绝望的	 [ˈdespərət] 
drastically	彻底地	['drɑ:stɪklɪ] 
exploit 	开发;功绩;	[ɪkˈsplɔɪt]
deficiency	缺陷	[dɪˈfɪʃnsi]
arsonist	纵火犯	[ˈɑ:sənɪst]
mob	犯罪团伙	[mɒb]
onlooker	旁观者	[ˈɒnlʊkə(r)]
rally	集合;重振	[ˈræli]
sworn	宣过誓的	[swɔ:n]
senator	参议员	[ˈsenətə(r)]
senate	被提名者	[ˌnɒmɪˈni:] 
supreme	最高的	[su:ˈpri:m]
court	法院;院子;网球场;求爱	[kɔ:t]
protester 	抗议者	[prəˈtestə(r)]
stealth	秘密行动	 [stelθ] 
compensate	补偿	 [ˈkɒmpenseɪt] 
disrupt 	使瓦解	[dɪsˈrʌpt]
impose	强加;征税;以…欺骗	[ɪmˈpəʊz] 
sanction	制裁，批准	[ˈsæŋkʃn]
apparent 	显然的	[əˈpærənt] 
dissident	持异议者	[ˈdɪsɪdənt]
derail 	出轨	[dɪˈreɪl] 
endeavor	努力	 [ɪn'devə] 
triple	三倍的	 [ˈtrɪpl]
overhaul	检修	 [ˈəʊvəhɔ:l] 
advisory	提供咨询的	[ədˈvaɪzəri] 
topology	拓扑结构;地质学	[tə'pɒlədʒɪ]
outage	断供	 [ˈaʊtɪdʒ]
algorithm	算法	 [ˈælgərɪðəm] 
epidemiology	流行病学	 [ˌepɪˌdi:miˈɒlədʒi] 
diagnostics	诊断学	[ˌdaɪəg'nɒstɪks] 
cardiovascular	心血管的	 [ˌkɑ:diəʊˈvæskjələ(r)] 
disease	疾病	 [dɪˈzi:z]
carotid	颈动脉（的）	 [kə'rɒtɪd]
adjacent	邻近的	[əˈdʒeɪsnt] 
stalled	停滞的	[stɔ:ld]
synchronizing	同步的	['sɪŋkrənaɪzɪŋ] 
mobility	移动性	 [məʊˈbɪləti] 
rigor	严格	 ['rɪgə]
rigorous	严格的	[ˈrɪgərəs]
trajectory	弹道	[trəˈdʒektəri]
crispness	易碎，精神愉快	 [krɪspnəs] 
recognition	识别;认可;褒奖	 [ˌrekəgˈnɪʃn]
hint	暗示	 [hɪnt] 
recap	概括	[ˈri:kæp]
immense	巨大的	 [ɪˈmens] 
versus	与…相对	 [ˈvɜ:səs] 
threshold	门槛，临界值	 [ˈθreʃhəʊld] 
ironical	具有讽刺意味的	[aɪ'rɒnɪkl]
typecast	类型转换	 [ˈtaɪpkɑ:st] 
distract	使分心	[dɪˈstrækt] 
unrivaled	无双的	 [ʌn'raɪvəld] 
compliment	向…致意	 [ˈkɒmplɪmənt] 
fluster	使慌乱	 [ˈflʌstə(r)]
comply	遵从	 [kəmˈplaɪ]
pivotal	中枢的	 [ˈpɪvətl]
stabilize	（使）稳定	 [ˈsteɪbəlaɪz] 
punctual	准时的	 [ˈpʌŋktʃuəl] 
kudos	荣誉	 [ˈkju:dɒs] 
groundbreaking	开创性的	[ˈgraʊndbreɪkɪŋ]
radical	激进的;彻底的	 [ˈrædɪkl]
roam	漫步	[rəʊm]
approval	批准	 [əˈpru:vl]
facilitate	促进	 [fəˈsɪlɪteɪt] 
outsourcing	外购	['aʊtsɔ:sɪŋ]
intervention	干预	[ˌɪntə'venʃn] 
tuned	调谐的	[tju:nd]
punctual	准时的	[ˈpʌŋktʃuəl] 
ethnicity	种族特点	[eθˈnɪsəti]
diversity	差异	 [daɪˈvɜ:səti] 
etiquette	礼仪	 [ˈetɪket]
enforcement	强制，执行	[ɪn'fɔ:smənt]
anticipate	预见	[ænˈtɪsɪpeɪt]
miserable	悲惨的	[ˈmɪzrəbl]
attendee	出席者	[ˌætenˈdi:] 
rebrand	给（产品或组织）重新命名（或包装）	 [ˌri:ˈbrænd]
collaborative	协作的	[kəˈlæbərətɪv] 
informative	提供信息的	 [ɪnˈfɔ:mətɪv] 
inform	通知	 [ɪnˈfɔ:m] 
pitch	扔	 [pɪtʃ]
digestible	易消化的	[daɪˈdʒestəbl]
amplify	放大	 [ˈæmplɪfaɪ]
cascade	串联;倾泻	 [kæˈskeɪd] 
remedy	补救办法	 [ˈremədi]
foray	突袭	[ˈfɒreɪ] 
metrics	韵律学	 ['metrɪks]
vertical	垂直的	 [ˈvɜ:tɪkl] 
revitalize	使复兴	 [ˌri:ˈvaɪtəlaɪz] 
morale	士气	[məˈrɑ:l]
criterion	标准	[kraɪˈtɪəriən] 
pursue	追	 [pəˈsju:] 
comprise	由…组成	[kəmˈpraɪz] 
dedicate	奉献	 [ˈdedɪkeɪt] 
formulate	规划;用公式表示	 [ˈfɔ:mjuleɪt] 
reinstate	使恢复	 [ˌri:ɪnˈsteɪt] 
incentive	动机;鼓励性质的	 [ɪnˈsentɪv] 
revenue	收益	[ˈrevənju:] 
behemoth	巨兽	 [bɪˈhi:mɒθ]
benchmark	基准	[ˈbentʃmɑ:k] 
par	平价的	 [pɑ:(r)]
in terms of	根据	
retain	保持	[rɪˈteɪn]
contrast	对照	[ˈkɒntrɑ:st] 
discrepancy	不符合（之处）	[dɪsˈkrepənsi] 
donation	捐赠	 [dəʊˈneɪʃn]
participatory	供人分享的	[pɑ:ˌtɪsɪ'peɪtərɪ] 
pretext	借口	[ˈpri:tekst]
mangosteen	山竹	[ˈmæŋgəsti:n]
30摄氏度	thirty degrees Celsius	
Celsius	摄氏	 [ˈselsiəs] 
centigrade	摄氏	[ˈsentɪgreɪd]
Fahrenheit	华氏	 [ˈfærənhaɪt] 
fluctuate	波动	 [ˈflʌktʃueɪt] 
racquetball	短网拍墙球	 [ˈrækɪtbɔ:l] 
quota	指标	[ˈkwəʊtə] 
electromagnetic	电磁的	 [ɪˌlektrəʊmægˈnetɪk]
electromagnetic oven	电磁炉	
shallot	葱	 [ʃəˈlɒt] 
coated	涂上一层的	['kəʊtɪd] 
haw	山楂	 [hɔ:]
Whether anyone buys the product is another question.		
participant	参与者	 [pɑ:ˈtɪsɪpənt] 
agenda	议程(agendum的复数)	[əˈdʒendə]
agendum	议程	 [ə'dʒendəm] 
scrum	并列争球;扭打	 [skrʌm] 
pecan	美洲山核桃	 [ˈpi:kən] 
reap	收割	 [ri:p]
chaff	谷壳;开玩笑	 [tʃɑ:f] 
yam	山药	 [jæm] 
acorn	橡（树果）实	[ˈeɪkɔ:n]
allocate	分配	 [ˈæləkeɪt] 
commiserate	同情	 [kəˈmɪzəreɪt] 
caffeine	咖啡因	 [ˈkæfi:n] 
consolidate	合并	[kənˈsɒlɪdeɪt]
tweak	拧	 [twi:k] 
automatic	自动的	 [ˌɔ:təˈmætɪk]
subsequent	随后的	 [ˈsʌbsɪkwənt] 
privilege	特权	 [ˈprɪvəlɪdʒ] 
canal	运河	 [kəˈnæl]
Dutch	荷兰人的，荷兰的，荷兰语的	 [dʌtʃ] 
therapy	治疗	[ˈθerəpi]
fruitful	果实累累的	 [ˈfru:tfl] 
capable	有才能的	[ˈkeɪpəbl] 
guru	领袖	 [ˈgʊru:]
keen	 热情的	 [ki:n] 
instruction	授课	[ɪnˈstrʌkʃn]
		
		
		
其过错与目前截肢存在主要因果关系，其原因力为	60-90	
原告经济损失264650.87元     的 70%是185255.61		
医疗费 	62734	医疗费：按照医疗事故对患者造成的人身损害进行治疗所发生的医疗费用计算，凭据支付，但不包括原发病医疗费用。结案后确实需要继续治疗的，按照基本医疗费用支付
住院伙食补助	50*126=6300	住院伙食补助费：按照医疗事故发生地国家机关一般工作人员的出差伙食补助标准计算。
护理费	39261/365*130=13983.37	陪护费：患者住院期间需要专人陪护的，按照医疗事故发生地上一年度职工年平均工资计算。
残疾赔偿金	24996*5*0.9=112482.00	残疾生活补助费：根据伤残等级，按照医疗事故发生地居民年平均生活费计算，自定残之月起最长赔偿30年;但是，60周岁以上的，不超过15年;70周岁以上的，不超过5年。
精神损害抚恤金	50000	精神损害抚慰金：按照医疗事故发生地居民年平均生活费计算。造成患者死亡的，赔偿年限最长不超过6年;造成患者残疾的，赔偿年限最长不超过3年。
交通费	3421.5	交通费：按照患者实际必需的交通费用计算，凭据支付。
住宿费	730	住宿费：按照医疗事故发生地国家机关一般工作人员的出差住宿补助标准计算，凭据支付。
鉴定费	15000	
假肢费没有实际发生		
		
		误工费：患者有固定收入的，按照本人因误工减少的固定收入计算，对收入高于医疗事故发生地上一年度职工年平均工资3倍以上的，按照3倍计算;无固定收入的，按照医疗事故发生地上一年度职工年平均工资计算。
		残疾用具费：因残疾需要配置补偿功能器具的，凭医疗机构证明，按照普及型器具的费用计算。
		丧葬费：按照医疗事故发生地规定的丧葬费补助标准计算。
		被扶养人生活费：以死者生前或者残疾者丧失劳动能力前实际扶养且没有劳动能力的人为限，按照其户籍所在地或者居所地居民最低生活保障标准计算。对不满16周岁的，扶养到16周岁。对年满16周岁但无劳动能力的，扶养20年;但是，60周岁以上的，不超过15年;70周岁以上的，不超过5年。
		参加医疗事故处理的患者近亲属所需交通费、误工费、住宿费，参照本条例第五十条的有关规定计算，计算费用的人数不超过2人。
		
问题		
护理费	应该按照三个人算	39261是葫芦岛职工平均工资？
残疾赔偿金	为什么乘以0.9（ 二级甲等医疗事故(二级伤残)按一级伤残的90%计算）	24996是居民年平均生活费？
精神损害抚恤金	法院判决说过高无法信服	
参加医疗事故处理的患者近亲属所需交通费、误工费、住宿费，参照本条例第五十条的有关规定计算，计算费用的人数不超过2人。没有算		
		
		
		
		
		
		
		
		
		
		
		
		
		
		
		
		
		
